platform.name,user.id,task.id,task.monetary_reward_in_dollars,task.assignable_hits_count,task.requester_name,task.estimate_duration_in_seconds,total.labor.event_count,total.labor.duration_in_seconds,working.labor.event_count,working.labor.duration_in_seconds,invisible.labor.event_count,invisible.labor.duration_in_seconds,adjusted.monetary_reward_in_dollars,completed_task
MTURK,ae862298385abab2a0a1619f8cedef9d,3W9XHF7WGLV68SQR2YVUGGPI6QVTK3,2.0,1.0,HCI Lab,7200,52,326,5,35,47,291,2.0905555555555555,1
MTURK,ae862298385abab2a0a1619f8cedef9d,3KA7IJSNW54MTVXHF3TMHNX8OOTPBI,0.15,1.0,PickFu,720,2,30,2,30,0,0,0.15625,1
MTURK,ae862298385abab2a0a1619f8cedef9d,3UEBBGULPFPBKLKAVLPVYAEF6LSUFW,0.3,23.0,CB Lab,3600,36,31,12,2,24,29,0.3025833333333333,0
MTURK,ae862298385abab2a0a1619f8cedef9d,3MQY1YVHS35Y79MCYT1FYVKHDBQB2G,2.0,80.0,Tamara Berg,3600,23,45,17,39,6,6,2.025,0
MTURK,ae862298385abab2a0a1619f8cedef9d,3E9VAUV7C0KFQYQSLVDQPISUFSBYA9,0.7,0.0,PP Group,14400,53,252,34,87,19,165,0.7122499999999999,1
MTURK,ae862298385abab2a0a1619f8cedef9d,307L9TDWJYSU5X3QAPDSGIUMBKC3ND,0.2,1.0,Kirk Wakefield,172800,50,115,29,8,21,107,0.20013310185185187,1
MTURK,ae862298385abab2a0a1619f8cedef9d,389A2A304OIIICG8DF1T1DF22WGC00,0.5,20.0,MSH University of Grenoble,1800,113,166,21,10,92,156,0.5461111111111111,0
MTURK,ae862298385abab2a0a1619f8cedef9d,3SNR5F7R91STS53HGDQSJBBU3NSIE8,0.2,40.0,SLS-6,1200,34,33,20,14,14,19,0.20550000000000002,0
MTURK,ae862298385abab2a0a1619f8cedef9d,375VMB7D4JK7T05MZHOWSEUJYFJDI0,0.5,0.0,PsychLabAtBC,1200,44,201,15,63,29,138,0.58375,1
MTURK,ae862298385abab2a0a1619f8cedef9d,3EQVJH0T40M4UDKGQD8XZ9P98S2THC,0.13,1.0,Tom Kramer,3600,51,52,19,4,32,48,0.1318777777777778,1
MTURK,ae862298385abab2a0a1619f8cedef9d,30EV7DWJUY8H7Y0TTM7KFN1IB5KY6T,0.1,46.0,Center for Decision Research (SJC),2700,60,136,10,9,50,127,0.10503703703703704,1
MTURK,ae862298385abab2a0a1619f8cedef9d,374UMBUHN6Z30O1ZNFYC8L7CRJ6TCU,2.0,0.0,youngseokwon,900,69,229,23,74,46,155,2.508888888888889,0
MTURK,ae862298385abab2a0a1619f8cedef9d,3UOMW19E6D2JP65CTWU6ZW9QM035CV,0.02,1.0,BigOven,1200,92,34,19,2,73,32,0.020566666666666667,0
MTURK,ae862298385abab2a0a1619f8cedef9d,3UQVX1UPFSHRZZDJ3ZKZW5XX2D002V,0.5,1.0,tiffani wang,900,98,226,47,31,51,195,0.6255555555555555,1
MTURK,ae862298385abab2a0a1619f8cedef9d,3HXCEECSQM1YAHV7LH2TWLBEBS5ZY5,0.1,11.0,AB Lab - University of Calgary,5400,143,297,61,55,82,242,0.10550000000000001,1
MTURK,ae862298385abab2a0a1619f8cedef9d,3IQ9O0AYW60BF98HR3HJEFI1A4UTIN,0.25,0.0,Markus Jakobsson,3600,29,72,17,42,12,30,0.255,0
MTURK,ae862298385abab2a0a1619f8cedef9d,3YLPJ8OXYCURKOALM6AOGFVBCNUX4B,6.0,0.0,Peter Andre,10800,235,2077,44,30,191,2047,7.153888888888889,0
MTURK,ae862298385abab2a0a1619f8cedef9d,3UEBBGULPF665X69NNGKKVU00LZFUX,0.35,1.0,ConsumerLab,1200,74,323,49,34,25,289,0.4442083333333333,1
MTURK,ae862298385abab2a0a1619f8cedef9d,3HJ1EVZS2OJFKVVI3WU9P2ZWCH53R5,0.2,1.0,Kirk Wakefield,86400,69,91,43,20,26,71,0.20021064814814815,1
MTURK,ae862298385abab2a0a1619f8cedef9d,3D1TUISJXL7AXVO1WFY850EAFOVIUV,0.35,1.0,Consumer Research Lab,1500,84,183,31,3,53,180,0.3927,1
MTURK,ae862298385abab2a0a1619f8cedef9d,3BFF0DJK8XC9IE2YIU3AFRJ3MIITS9,0.3,1.0,syu,1800,45,168,17,107,28,61,0.328,1
MTURK,ae862298385abab2a0a1619f8cedef9d,3FCO4VKO07XVVIKQDW4CBQVIJH37EZ,0.7,89.0,The People Lab,18000,65,362,40,27,25,335,0.7140777777777777,1
MTURK,ae862298385abab2a0a1619f8cedef9d,35JDMRECC5SHS0NQU5X2I7CRP94EGA,2.0,1.0,Mia Park,3600,102,653,39,13,63,640,2.3627777777777776,1
MTURK,ae862298385abab2a0a1619f8cedef9d,35O6H0UNLUE4Y4FTGJ6VDCJKB34J5R,0.15,247.0,Sophie,3600,69,81,24,42,45,39,0.15337499999999998,0
MTURK,ae862298385abab2a0a1619f8cedef9d,302U8RURJZ2P9NVP46UZA62SPA1VNK,0.5,0.0,erica,3600,104,345,43,11,61,334,0.5479166666666667,0
MTURK,ae862298385abab2a0a1619f8cedef9d,3TCFMTM8HEERF4I4E3D5IW9NJZJ12O,0.39,1.0,STQ-Surveys,3600,66,44,30,5,36,39,0.39476666666666665,0
MTURK,ae862298385abab2a0a1619f8cedef9d,3QD8LUVX503XYN9EUP5QPT48WYS5XX,1.0,1.0,SeomgyunLee,3600,61,251,39,141,22,110,1.0697222222222222,1
MTURK,ae862298385abab2a0a1619f8cedef9d,3N5YJ55YXG3AVVNQ3MIU09Y29Q1AN7,0.45,1.0,Chulakorn Aritajati,3600,33,143,21,101,12,42,0.46787500000000004,1
MTURK,ae862298385abab2a0a1619f8cedef9d,391JB9X4ZYRRU7Y18HUN27PRAQ1KM9,0.2,86.0,chris.lab111,3600,55,103,27,8,28,95,0.20572222222222222,1
MTURK,ae862298385abab2a0a1619f8cedef9d,37M4O367VJO9QRYT7BXPHJ20C3I5M2,0.0,0.0,Nina Xue,1800,136,483,42,7,94,476,0.0,1
MTURK,ae862298385abab2a0a1619f8cedef9d,3MZ3TAMYTKMLH0U0Q9T4A998KFTRI5,0.04,109.0,OKB,300,24,51,21,45,3,6,0.0468,1
MTURK,ae862298385abab2a0a1619f8cedef9d,3INZSNUD80QMACUQYFYWK9BV0CH9D6,0.3,1.0,Arant Lin,3600,53,311,30,81,23,230,0.32591666666666663,1
MTURK,ae862298385abab2a0a1619f8cedef9d,3B286OTISDGH9UIVT7YK97YJJWAAJ0,0.25,570.0,joanna socha,14400,59,45,28,17,31,28,0.25078125,0
MTURK,ae862298385abab2a0a1619f8cedef9d,3E9ZFLPWO0KJDJRNXDHG072XWOZXIK,0.1,1.0,Anirban Kar,3600,20,29,9,19,11,10,0.10080555555555556,1
MTURK,ae862298385abab2a0a1619f8cedef9d,3Y40HMYLL1JUL71FVD8WMAA6SFEUXF,0.0,1.0,Amazon Mechanical Turk Team,3600,38,66,21,50,17,16,0.0,1
MTURK,ae862298385abab2a0a1619f8cedef9d,3VJ4PFXFJ37NNOZUVUQ53P88EIUUAD,1.0,32.0,Diana,7200,60,65,21,16,39,49,1.0090277777777779,0
MTURK,ae862298385abab2a0a1619f8cedef9d,36BTXXLZ2WFUZP6BE0XGNRRRJ8MR4D,0.3,13.0,John Robb,3600,40,56,13,5,27,51,0.30466666666666664,1
MTURK,ae862298385abab2a0a1619f8cedef9d,3KVQ0UJWPXLA9WOZXUE27WTSXEF5WE,0.1,1.0,Zarren Kuzma,900,25,31,17,15,8,16,0.10344444444444445,0
MTURK,ae862298385abab2a0a1619f8cedef9d,3UEBBGULPHCLXNXLMYSGTPQO9YJFU1,2.75,15.0,Noah Turk,1800,19,32,11,29,8,3,2.798888888888889,0
MTURK,ae862298385abab2a0a1619f8cedef9d,3R15W654VDPG5EA716M2OO7E2XYLQX,0.5,1.0,Goldberg Imports,86400,91,65,25,21,66,44,0.5003761574074074,1
MTURK,ae862298385abab2a0a1619f8cedef9d,31KSVEGZ36RRW4QG86C2II4RIDTRW4,0.03,724.0,Cornell Datavis Lab,300,43,32,11,0,32,32,0.0332,0
MTURK,ae862298385abab2a0a1619f8cedef9d,3P0I4CQYVYRAH3EVE05W46C8AJXWOT,0.2,1.0,OSU Spatial Health Lab,600,30,60,17,47,13,13,0.22000000000000003,1
MTURK,ae862298385abab2a0a1619f8cedef9d,386659BNTLFTD6UZ3FGOJHDX1GJ01H,0.2,13.0,I Shanks,1800,71,174,23,91,48,83,0.21933333333333335,1
MTURK,ae862298385abab2a0a1619f8cedef9d,3X4Q1O9UBIOC0WTN7PYVS5DZJFHO75,0.75,0.0,Resumes,3600,116,180,69,95,47,85,0.7875,1
MTURK,ae862298385abab2a0a1619f8cedef9d,3MVY4USGB7PON82CXXJ13ZD9UKVSI1,0.75,0.0,Resumes,3600,134,150,86,58,48,92,0.78125,1
MTURK,ae862298385abab2a0a1619f8cedef9d,3L1EFR8WWTGPOH9JR3MPJI2BENZ9FT,0.46,4.0,Zeyu Jin,1200,59,163,17,25,42,138,0.5224833333333334,0
MTURK,ae862298385abab2a0a1619f8cedef9d,3XQ4XW3ODAGMJ417AZVY3ZJ20AJS2Z,0.12,7.0,quarrel-recast,600,46,48,20,18,26,30,0.1296,0
MTURK,ae862298385abab2a0a1619f8cedef9d,30OITAWPBQ4XI95SUB4UUVULTA8H99,0.3,30.0,MPR Lab,600,38,84,11,46,27,38,0.34199999999999997,1
MTURK,ae862298385abab2a0a1619f8cedef9d,3VDI8GSXAESQEOUTG0QEADZPZG1G8K,0.24,35.0,Stanford GSB Behavioral Lab,900,60,95,13,14,47,81,0.2653333333333333,1
MTURK,ae862298385abab2a0a1619f8cedef9d,31YWE12TE1QDGF5JXY8OQX6OS0D7X4,0.4,32.0,Keith Wilcox,1200,70,188,18,92,52,96,0.46266666666666667,1
MTURK,ae862298385abab2a0a1619f8cedef9d,3N3WJQXELSJOIYSCX41UA1OOCVQ2LA,0.5,38.0,SCIP Lab,1800,141,132,22,9,119,123,0.5366666666666666,0
MTURK,ae862298385abab2a0a1619f8cedef9d,3EKZL9T8Y8DM6YZHCX2LU74Y3FBCHJ,0.2,8.0,Deep Dialogue,3600,55,37,12,0,43,37,0.20205555555555557,0
MTURK,ae862298385abab2a0a1619f8cedef9d,31SIZS5W58ENXAJ9HUK9TWUZ8ATQRD,0.08,3.0,Mind and Language,900,21,31,20,22,1,9,0.08275555555555555,1
MTURK,ae862298385abab2a0a1619f8cedef9d,359AP8GAGGL2V31XW1YF8UQWC137CG,5.0,0.0,Ranjitha,5400,202,897,61,395,141,502,5.830555555555556,1
MTURK,ae862298385abab2a0a1619f8cedef9d,3KVQ0UJWPYSH34RXRZQWFI5MBN75WI,0.3,0.0,John Robb,3600,145,600,65,380,80,220,0.35,1
MTURK,ae862298385abab2a0a1619f8cedef9d,3RIHDBQ1NF0HXP56LNYAYT3075FMHH,2.0,0.0,mturk cda,4200,1383,3229,189,277,1194,2952,3.5376190476190477,0
MTURK,ae862298385abab2a0a1619f8cedef9d,3HYV4299H1369MO84X3T5W8D693E8D,0.3,2.0,John Robb,3600,72,41,29,2,43,39,0.30341666666666667,1
MTURK,ae862298385abab2a0a1619f8cedef9d,3566S7OX5DJPNW52EA0SEC44UT717O,0.3,0.0,UM,3600,29,30,14,8,15,22,0.3025,0
MTURK,ae862298385abab2a0a1619f8cedef9d,33KMQD9OFJMICQOH94AHU0UDQNY772,0.04,4.0,"Data Science Group, The New York Times",360,49,68,29,32,20,36,0.04755555555555556,1
MTURK,ae862298385abab2a0a1619f8cedef9d,3W5PY7V3URRR4CXLXHMZJ5GL7NEJYT,3.0,76.0,Ma Study,3600,87,786,32,19,55,767,3.6550000000000002,1
MTURK,ae862298385abab2a0a1619f8cedef9d,3PA41K45VPO4B34I5L1J3OI0CNB7PG,3.0,63.0,Ma Study,3600,43,29,25,12,18,17,3.024166666666667,0
MTURK,ae862298385abab2a0a1619f8cedef9d,3S829FDFU58XTRIKU9IAOB5PGQVDXU,0.15,8523.0,Conversational AI,3600,25,49,20,44,5,5,0.15204166666666666,0
MTURK,ae862298385abab2a0a1619f8cedef9d,3A9LA2FRWSE9YD6QM1R1FE03U2GXHF,0.02,1.0,cindy hong,180,41,37,32,22,9,15,0.02411111111111111,1
MTURK,ae862298385abab2a0a1619f8cedef9d,3LEG2HW4UFNKW24LWS01VNEMZS5F22,0.2,1.0,researcher,3600,26,1820,17,9,9,1811,0.3011111111111111,1
MTURK,ae862298385abab2a0a1619f8cedef9d,362E9TQF2HQYVWZJ2IVG39UG4V7GIE,0.3,30.0,CB Research Lab,1800,71,213,27,67,44,146,0.33549999999999996,1
MTURK,ae862298385abab2a0a1619f8cedef9d,36FFXPMSUC71CJWIN8UD9C0DBZFHON,0.2,45.0,Violet Peng,3600,23,88,14,58,9,30,0.2048888888888889,1
MTURK,ae862298385abab2a0a1619f8cedef9d,3D1TUISJWI5X16FODDQ7G8AADTVIUL,3.75,70.0,Research Methods,7200,23,30,12,3,11,27,3.765625,0
MTURK,ae862298385abab2a0a1619f8cedef9d,3XQ4XW3ODAXQDT2T16V6TVP8YXIS2X,1.0,0.0,Hyunsun Park,3600,51,480,13,12,38,468,1.1333333333333333,0
MTURK,ae862298385abab2a0a1619f8cedef9d,3MDKGGG61Q68I9W88AQDBEC9YJK6T2,0.75,0.0,K.L. Kettle,1800,20,339,14,227,6,112,0.89125,1
MTURK,ae862298385abab2a0a1619f8cedef9d,3OND0WXMHWY2GT5GLY37C74Q9A3HEG,0.35,0.0,chris.lab111,14400,49,420,29,71,20,349,0.3602083333333333,1
MTURK,ae862298385abab2a0a1619f8cedef9d,3D0LPO3EAB62K9LNK4AUQLU1MWGOYH,0.5,0.0,Language and Cognition Lab,1200,63,120,40,64,23,56,0.55,0
MTURK,ae862298385abab2a0a1619f8cedef9d,3L55D8AUFAG95QBRZ7108JZQEU4YC4,0.15,95.0,chris.lab111,3600,18,59,14,39,4,20,0.15245833333333333,1
MTURK,ae862298385abab2a0a1619f8cedef9d,37SOB9Z0SSY8PYH6LI38GZVB6W2L3M,0.2,35.0,Didem Kurt,1200,44,146,28,87,16,59,0.22433333333333336,1
MTURK,ae862298385abab2a0a1619f8cedef9d,3LN3BXKGC0VJHT61HR1OMT0DZ9GWGJ,0.01,1.0,Steve Berry,300,13,30,8,7,5,23,0.011,1
MTURK,ae862298385abab2a0a1619f8cedef9d,3KWGG5KP6J8FJ3JYZUP5ETYR74HMCG,1.0,1.0,Jonathan Rolison,3000,41,90,18,64,23,26,1.03,0
MTURK,ae862298385abab2a0a1619f8cedef9d,3S1L4CQSG1T8LPO6Z1W060XMWZPFAE,0.75,1.0,Survey Launcher,1800,31,218,26,26,5,192,0.8408333333333333,1
MTURK,ae862298385abab2a0a1619f8cedef9d,3QI9WAYOGQ0FMEJDAIRDGHO3RAI6SF,0.1,1.0,Mattress Advisor,600,15,120,12,87,3,33,0.12000000000000001,1
MTURK,ae862298385abab2a0a1619f8cedef9d,3BAKUKE4AKPZNTVY7Y5VCCA5MS91RB,0.15,1.0,Patrick Healey,1800,14,119,5,45,9,74,0.15991666666666665,1
MTURK,ae862298385abab2a0a1619f8cedef9d,3M0556243RJC3RXK4Q2QWOJY3G6NF6,0.35,1.0,PickFu,2746,4,149,4,0,0,149,0.3689912600145666,1
MTURK,149c64b9f9b890bcf32bd2dcf595fd,3W9XHF7WGLV68SQR2YVUGGPI6QVTK3,2.0,1.0,HCI Lab,7200,68,950,5,26,63,924,2.263888888888889,1
MTURK,149c64b9f9b890bcf32bd2dcf595fd,3QREJ3J433IU1T71CX85W6LDXYZKLE,4.5,10.0,SYL,10800,856,5125,28,92,828,5033,6.635416666666667,1
MTURK,149c64b9f9b890bcf32bd2dcf595fd,3YD0MU1NC2MPAV9DWCU6JN0GX1C7AN,4.5,10.0,SYL,10800,943,6197,36,187,907,6010,7.082083333333333,1
MTURK,149c64b9f9b890bcf32bd2dcf595fd,35U0MRQMUJSGNP4AOT24QW0O81BOVL,4.5,10.0,SYL,10800,72,60,43,25,29,35,4.525,0
MTURK,149c64b9f9b890bcf32bd2dcf595fd,3YLTXLH3DGJXVA1OEIJ7IUHILVCHPF,1.0,1.0,Syntiant MTurk,3600,57,832,14,140,43,692,1.231111111111111,1
MTURK,149c64b9f9b890bcf32bd2dcf595fd,3CMIQF80GN0XWBC81XEGMJKYJB8Q64,0.05,90.0,DiCarlo Lab,600,19,179,12,142,7,37,0.06491666666666668,1
MTURK,149c64b9f9b890bcf32bd2dcf595fd,3S1L4CQSFXCZ8C5CEVGY2LHATU9AFF,3.0,0.0,Edward Gibson,5400,14,1057,13,1053,1,4,3.587222222222222,1
MTURK,149c64b9f9b890bcf32bd2dcf595fd,301KG0KX9BKYJG6VL2JVUSRHQV1H23,0.2,1.0,Caris,3600,36,785,17,9,19,776,0.2436111111111111,0
MTURK,149c64b9f9b890bcf32bd2dcf595fd,391JB9X4ZYTE7BPMC99KWJ02X3PKMG,4.5,11.0,SYL,10800,658,76958,185,1798,473,75160,36.56583333333334,0
MTURK,149c64b9f9b890bcf32bd2dcf595fd,3TFJJUELSHA6H995AE92TR9WMPD2C8,4.5,11.0,SYL,10800,21,4380,2,28,19,4352,6.325,1
MTURK,149c64b9f9b890bcf32bd2dcf595fd,3HUR21WDEXJOBYKB4KOVH1EP07UXYD,2.5,0.0,rasa-research,1800,71,68871,16,59,55,68812,98.15416666666667,1
MTURK,49e7482b6cda157f388c73b3bcc2ebfc,3W9XHF7WGLV68SQR2YVUGGPI6QVTK3,2.0,1.0,HCI Lab,7200,56,648,6,99,50,549,2.18,1
MTURK,49e7482b6cda157f388c73b3bcc2ebfc,3YLTXLH3DGJXVA1OEIJ7IUHILVCHPF,1.0,1.0,Syntiant MTurk,3600,97,12803,10,103,87,12700,4.556388888888889,1
MTURK,49e7482b6cda157f388c73b3bcc2ebfc,3S829FDFT28E65Z9YZDMYTPNI28DXH,3.0,0.0,Edward Gibson,5400,274,3868,117,1429,157,2439,5.148888888888889,1
MTURK,49e7482b6cda157f388c73b3bcc2ebfc,33KMQD9OGNEGFJM1CC14J83R6KW77O,0.05,1035.0,Taeyeong Kim,1800,4,211,3,206,1,5,0.05586111111111111,1
MTURK,49e7482b6cda157f388c73b3bcc2ebfc,3MWOYZD5XZOC3A6N95ZVQRBCWOBON6,0.05,949.0,Taeyeong Kim,1800,10,117,10,116,0,1,0.053250000000000006,1
MTURK,49e7482b6cda157f388c73b3bcc2ebfc,3LOJFQ4BOXNVLE5RU8YW84P9IRPKD5,0.02,112.0,swati panda,1800,57,1826,9,4,48,1822,0.04028888888888889,1
MTURK,49e7482b6cda157f388c73b3bcc2ebfc,32204AGAACYE4SPK5CBF17T49ECGH3,1.0,1.0,HBS Behavioral Research,3600,311,1829,100,294,211,1535,1.5080555555555555,1
MTURK,49e7482b6cda157f388c73b3bcc2ebfc,3SV8KD29L4NHBY1VOGOC3L7OGASZKZ,0.07,524.0,Upside Services Inc,3600,76,260,61,209,15,51,0.07505555555555557,1
MTURK,49e7482b6cda157f388c73b3bcc2ebfc,31MBOZ6PAOMFNB83H2G57NJIWTLLC1,0.07,591.0,Upside Services Inc,3600,41,235,29,225,12,10,0.07456944444444445,0
MTURK,49e7482b6cda157f388c73b3bcc2ebfc,3E6L1VR4XXQ6QWK0ABMGI2Z5TL8F65,0.08,134.0,AVID Annotation,1800,251,1063,34,111,217,952,0.12724444444444444,0
MTURK,49e7482b6cda157f388c73b3bcc2ebfc,3R868ACW4S7C9C5CYP3X5TFV9UKGZO,0.07,6021.0,Upside Services Inc,3600,58,187,39,146,19,41,0.07363611111111112,0
MTURK,49e7482b6cda157f388c73b3bcc2ebfc,37ZQELHEQ0XJRE96CKSB6UTB3Z8NMN,0.07,380.0,Oliver,600,134,210,41,25,93,185,0.0945,0
MTURK,49e7482b6cda157f388c73b3bcc2ebfc,39O6Z4JLX2W7TVHJSIGBRS3MW6VXVZ,0.07,466.0,Oliver,600,84,141,44,60,40,81,0.08645000000000001,1
MTURK,49e7482b6cda157f388c73b3bcc2ebfc,3O2Y2UIUCRI12UR5YVXWHBZNV2CKFU,0.1,351.0,MLDataLabeler,600,23,60,12,6,11,54,0.11000000000000001,1
MTURK,49e7482b6cda157f388c73b3bcc2ebfc,3D0LPO3EACNQSCTF1DHDDDNCLIBYOO,0.1,18.0,MLDataLabeler,600,56,90,24,18,32,72,0.115,1
MTURK,49e7482b6cda157f388c73b3bcc2ebfc,36AZSFEYZ5OP1DMB27PJCMMLC66BVK,0.1,669.0,MLDataLabeler,600,48,140,18,58,30,82,0.12333333333333335,1
MTURK,49e7482b6cda157f388c73b3bcc2ebfc,37OPIVELUVRF02MZR48J2AB6M9AHA5,0.1,581.0,MLDataLabeler,600,43,95,23,39,20,56,0.11583333333333334,1
MTURK,49e7482b6cda157f388c73b3bcc2ebfc,39N6W9XWREB2WOPRN44HKWHCA00YGX,0.1,516.0,MLDataLabeler,600,31,101,24,17,7,84,0.11683333333333334,1
MTURK,49e7482b6cda157f388c73b3bcc2ebfc,3WKGUBL7S0A2K9P89ODQHZIDBGO4LP,0.1,416.0,MLDataLabeler,600,33,120,15,10,18,110,0.12000000000000001,1
MTURK,49e7482b6cda157f388c73b3bcc2ebfc,3Y3CZJSZ9LHVJQOLSDTW83XQH47R56,0.1,318.0,MLDataLabeler,600,33,100,17,9,16,91,0.11666666666666667,1
MTURK,49e7482b6cda157f388c73b3bcc2ebfc,33CLA8O0MJZNLNHAYP65UFO36YLRFP,0.1,231.0,MLDataLabeler,600,61,100,27,3,34,97,0.11666666666666667,0
MTURK,49e7482b6cda157f388c73b3bcc2ebfc,3RDTX9JRTZP42U6IMP87F2BS2OX79F,0.1,1.0,MLDataLabeler,600,184,604,57,200,127,404,0.2006666666666667,0
MTURK,49e7482b6cda157f388c73b3bcc2ebfc,371Q3BEXDIX5VUVD4G05BP6FO1MSZA,0.1,229.0,MLDataLabeler,600,36,66,14,12,22,54,0.111,1
MTURK,49e7482b6cda157f388c73b3bcc2ebfc,3P7RGTLO6F1663AXNFB43AOWYM2AKA,0.1,229.0,MLDataLabeler,600,44,46,19,6,25,40,0.10766666666666667,1
MTURK,49e7482b6cda157f388c73b3bcc2ebfc,3JHB4BPSFLXECNYN8EH131PLRACQ93,0.1,73.0,MLDataLabeler,600,29,33,15,2,14,31,0.10550000000000001,1
MTURK,49e7482b6cda157f388c73b3bcc2ebfc,3GITHABACZ9I5VD6HNAH1CP4WXSN2E,0.01,50.0,MLDataLabeler,300,26,42,13,21,13,21,0.0114,1
MTURK,49e7482b6cda157f388c73b3bcc2ebfc,3CMIQF80GOERRPUJ3MVCQJR0SL4Q6S,0.01,82.0,MLDataLabeler,300,22,35,11,23,11,12,0.011166666666666667,1
MTURK,49e7482b6cda157f388c73b3bcc2ebfc,3FULMHZ7OVLMU2UJZQET5KU0VH2M4H,0.1,525.0,MLDataLabeler,600,46,113,10,9,36,104,0.11883333333333335,1
MTURK,49e7482b6cda157f388c73b3bcc2ebfc,3MD8CKRQZ0B3U0QW75XEXLDTJ1RJRT,0.1,461.0,MLDataLabeler,600,36,57,16,25,20,32,0.10950000000000001,1
MTURK,49e7482b6cda157f388c73b3bcc2ebfc,38XPGNCKHUO5KPOSDIFKSGDDMAF4VH,0.1,390.0,MLDataLabeler,600,38,43,19,7,19,36,0.10716666666666667,1
MTURK,49e7482b6cda157f388c73b3bcc2ebfc,34ZTTGSNJYC7RTG66Q5TGIN9ANMHQM,0.1,291.0,MLDataLabeler,600,38,56,21,3,17,53,0.10933333333333334,1
MTURK,49e7482b6cda157f388c73b3bcc2ebfc,3N2YPY1GI7MNCRLL2ORX12P4ZZ8VED,0.1,285.0,MLDataLabeler,600,26,43,16,3,10,40,0.10716666666666667,1
MTURK,49e7482b6cda157f388c73b3bcc2ebfc,3IKDQS3DQFO3TNH77QMJWPZ76L0CI5,0.1,115.0,MLDataLabeler,600,26,47,16,3,10,44,0.10783333333333334,1
MTURK,49e7482b6cda157f388c73b3bcc2ebfc,3X878VYTIF6D7FKLF18ND6U1PIH7FG,0.1,0.0,MLDataLabeler,600,22,162,14,95,8,67,0.127,1
MTURK,49e7482b6cda157f388c73b3bcc2ebfc,37S0QRNUFBG4Y4JRN2PXBL05BVV886,0.5,1.0,John Wixted,900,3360,80146,805,2089,2555,78057,45.025555555555556,0
MTURK,49e7482b6cda157f388c73b3bcc2ebfc,3P4C70TRNUZKXK0O3T71MEEEKX0LGX,0.02,0.0,Sam Davis,600,22,92,5,4,17,88,0.023066666666666666,1
MTURK,49e7482b6cda157f388c73b3bcc2ebfc,3PUOXASB573SHBAVXEFT0L6D0N3Z90,2.0,0.0,Rachel Burgess,5400,202,2072,33,115,169,1957,2.7674074074074073,1
MTURK,49e7482b6cda157f388c73b3bcc2ebfc,3MXX6RQ9EX4L0YZTM0VYMJZ0UPE4PD,1.0,0.0,Faisal,2400,211,1409,85,635,126,774,1.5870833333333334,1
MTURK,49e7482b6cda157f388c73b3bcc2ebfc,3G5RUKN2EB25154K8M60KEN9MIF9NC,1.2,0.0,Christopher E. Wilson,2700,126,750,51,78,75,672,1.5333333333333332,1
MTURK,49e7482b6cda157f388c73b3bcc2ebfc,3B623HUYJ5VFG5ZHRAM5AFUOUFQ8SV,0.04,62.0,Marketing Research,10800,190,353,105,172,85,181,0.04130740740740741,1
MTURK,49e7482b6cda157f388c73b3bcc2ebfc,3D4BBDG70L3FULZ1LS315Z4V8FI3CO,0.63,2.0,NVIDIA SRL MTURK,1800,22,34,16,30,6,4,0.6419,0
MTURK,49e7482b6cda157f388c73b3bcc2ebfc,3PKJ68EHDN123KJPEBG91XCWYR7JHX,0.25,60.0,Alan Ritter,1800,110,299,54,187,56,112,0.2915277777777778,0
MTURK,49e7482b6cda157f388c73b3bcc2ebfc,3W31J70BBWHHRO7M3MVYA23XXXLCKD,0.02,171.0,AAH MTurk,3600,208,582,90,230,118,352,0.023233333333333335,0
MTURK,49e7482b6cda157f388c73b3bcc2ebfc,3W31J70BBVKXG9DOMPWBHW3EYOKCK6,0.14,657.0,Dimitrios Papadopoulos,420,57,239,30,63,27,176,0.21966666666666668,0
MTURK,49e7482b6cda157f388c73b3bcc2ebfc,3OEWW2KGRMZQBS4HKDJF8J253T6DOR,0.14,635.0,Dimitrios Papadopoulos,420,85,1416,39,1207,46,209,0.6120000000000001,0
MTURK,49e7482b6cda157f388c73b3bcc2ebfc,3K3IX1W4T9FAYLD6F35S7IZPSV5PAI,0.14,573.0,Dimitrios Papadopoulos,420,39,138,16,29,23,109,0.18600000000000003,0
MTURK,49e7482b6cda157f388c73b3bcc2ebfc,39WICJI5BWG4S4GRTXOKB8NXWKJZ3G,0.14,567.0,Dimitrios Papadopoulos,420,49,137,20,16,29,121,0.1856666666666667,0
MTURK,49e7482b6cda157f388c73b3bcc2ebfc,33CLA8O0NLZQ6PAT3BV9QEAVQT6RFP,0.14,563.0,Dimitrios Papadopoulos,420,26,107,12,6,14,101,0.1756666666666667,0
MTURK,49e7482b6cda157f388c73b3bcc2ebfc,3BDORL6HLN1J3DQJC958I8PSTGECRZ,0.14,548.0,Dimitrios Papadopoulos,420,29,171,12,10,17,161,0.197,1
MTURK,49e7482b6cda157f388c73b3bcc2ebfc,309D674SI29WN69UGCJIITKOBUBCBM,0.14,542.0,Dimitrios Papadopoulos,420,31,177,14,15,17,162,0.199,0
MTURK,49e7482b6cda157f388c73b3bcc2ebfc,36FFXPMSUCC7N89J6925Z4H3VLZOHB,0.14,536.0,Dimitrios Papadopoulos,420,37,183,17,6,20,177,0.201,0
MTURK,49e7482b6cda157f388c73b3bcc2ebfc,31HLTCK4COJODWN5NF619WZACEJGV6,0.14,536.0,Dimitrios Papadopoulos,420,33,107,15,6,18,101,0.1756666666666667,0
MTURK,49e7482b6cda157f388c73b3bcc2ebfc,3RZS0FBRXNYYR0A4ZH1JDDPDSYQCP7,0.14,516.0,Dimitrios Papadopoulos,420,26,136,12,2,14,134,0.18533333333333335,0
MTURK,49e7482b6cda157f388c73b3bcc2ebfc,3WA2XVDZFP55ESCDGC85X1YZI5DE6W,0.14,508.0,Dimitrios Papadopoulos,420,27,143,11,22,16,121,0.18766666666666668,0
MTURK,49e7482b6cda157f388c73b3bcc2ebfc,3A3KKYU7Q651KVJWOS9S832LF9WWM3,0.14,503.0,Dimitrios Papadopoulos,420,12,59,6,4,6,55,0.15966666666666668,0
MTURK,49e7482b6cda157f388c73b3bcc2ebfc,3X2LT8FDIZ6MZ6HSURZ93L1QV47W8F,0.14,462.0,Dimitrios Papadopoulos,420,31,322,10,4,21,318,0.24733333333333335,1
MTURK,49e7482b6cda157f388c73b3bcc2ebfc,3KLL7H3EHGP2DSIG7LOJUWBBREVHV5,0.14,458.0,Dimitrios Papadopoulos,420,28,135,12,2,16,133,0.18500000000000003,0
MTURK,49e7482b6cda157f388c73b3bcc2ebfc,3X7837UUBGMDP8Y5UDJWUHBRND9J6M,0.14,427.0,Dimitrios Papadopoulos,420,33,209,14,13,19,196,0.2096666666666667,0
MTURK,49e7482b6cda157f388c73b3bcc2ebfc,3BFNCI9LZNEL8UALA2W1KOUYMR673W,0.14,419.0,Dimitrios Papadopoulos,420,19,145,9,9,10,136,0.18833333333333335,1
MTURK,49e7482b6cda157f388c73b3bcc2ebfc,3FTID4TN9OML3IWB3HQ1TN8CQC6YL2,0.14,398.0,Dimitrios Papadopoulos,420,36,340,16,27,20,313,0.25333333333333335,1
MTURK,49e7482b6cda157f388c73b3bcc2ebfc,3BDORL6HLN1J3DQJC958I8PSTGERCE,0.14,381.0,Dimitrios Papadopoulos,420,33,157,16,7,17,150,0.19233333333333336,1
MTURK,49e7482b6cda157f388c73b3bcc2ebfc,3QI9WAYOHTZ6OBHVH7SAMI2EJWM6SP,0.14,368.0,Dimitrios Papadopoulos,420,33,184,14,4,19,180,0.20133333333333336,1
MTURK,49e7482b6cda157f388c73b3bcc2ebfc,3XABXM4AK4THF9L6II03BWJ473RQ86,0.14,351.0,Dimitrios Papadopoulos,420,26,147,14,25,12,122,0.18900000000000003,1
MTURK,49e7482b6cda157f388c73b3bcc2ebfc,3QD8LUVX50MI1O3G6YOSTK562GDX58,0.14,335.0,Dimitrios Papadopoulos,420,15,156,7,1,8,155,0.192,1
MTURK,49e7482b6cda157f388c73b3bcc2ebfc,3L1EFR8WXWTK2PE79UVNZTA1K709FK,0.14,313.0,Dimitrios Papadopoulos,420,25,200,10,20,15,180,0.2066666666666667,0
MTURK,49e7482b6cda157f388c73b3bcc2ebfc,3BCRDCM0PGI80S4NCYJ8VWB42296K8,0.14,312.0,Dimitrios Papadopoulos,420,20,41,8,1,12,40,0.15366666666666667,0
MTURK,49e7482b6cda157f388c73b3bcc2ebfc,3RDTX9JRU1P7NWZ1RBXBB1XKMJH79E,0.14,293.0,Dimitrios Papadopoulos,420,19,164,9,15,10,149,0.19466666666666668,1
MTURK,49e7482b6cda157f388c73b3bcc2ebfc,3EFNPKWBNVC7QJA1P3BS59KBED203R,0.14,291.0,Dimitrios Papadopoulos,420,14,57,6,11,8,46,0.15900000000000003,0
MTURK,49e7482b6cda157f388c73b3bcc2ebfc,37YYO3NWIGEFXB10UCFDTDQ6TFACCS,0.14,281.0,Dimitrios Papadopoulos,420,23,163,11,16,12,147,0.19433333333333336,1
MTURK,49e7482b6cda157f388c73b3bcc2ebfc,3BKZLF9912NWUFCOVMYXA9760ITYQR,0.14,262.0,Dimitrios Papadopoulos,420,33,279,12,7,21,272,0.23300000000000004,0
MTURK,49e7482b6cda157f388c73b3bcc2ebfc,3H781YYV7W6BGQNPCPGY8BQD2DOET7,0.14,225.0,Dimitrios Papadopoulos,420,9,443,7,403,2,40,0.28766666666666674,1
MTURK,49e7482b6cda157f388c73b3bcc2ebfc,36GJS3V79YEFM1NB6QSI68OGHRCGJL,0.14,9.0,Dimitrios Papadopoulos,420,35,97,12,35,23,62,0.17233333333333334,0
MTURK,49e7482b6cda157f388c73b3bcc2ebfc,37J05LC5B07CAHDK40RA0NLJ4ZWDJ8,0.14,9.0,Dimitrios Papadopoulos,420,27,135,11,66,16,69,0.18500000000000003,0
MTURK,49e7482b6cda157f388c73b3bcc2ebfc,3D0LPO3EBENT93Z8G96TL4C6LHCOYA,0.14,9.0,Dimitrios Papadopoulos,420,25,117,11,89,14,28,0.17900000000000002,0
MTURK,49e7482b6cda157f388c73b3bcc2ebfc,3XWUWJ18UOE75ZZ02ULDHPYI7FPUUV,0.14,10.0,Dimitrios Papadopoulos,420,33,177,12,56,21,121,0.199,0
MTURK,49e7482b6cda157f388c73b3bcc2ebfc,3R5LWXWHS3WGHLS0NU7JXHWVSPRGX9,0.14,7.0,Dimitrios Papadopoulos,420,21,144,8,9,13,135,0.18800000000000003,0
MTURK,49e7482b6cda157f388c73b3bcc2ebfc,3CMIQF80HQEUBV2IP335RIND1816Q0,0.14,7.0,Dimitrios Papadopoulos,420,32,160,12,16,20,144,0.19333333333333336,0
MTURK,49e7482b6cda157f388c73b3bcc2ebfc,3ICOHX7EOFZA0HQYENSOO0O852RE0V,0.14,5.0,Dimitrios Papadopoulos,420,31,114,12,27,19,87,0.17800000000000002,0
MTURK,49e7482b6cda157f388c73b3bcc2ebfc,3PGQRAZX15887VR1NQN259M7I6EYSG,0.14,2.0,Dimitrios Papadopoulos,420,36,112,13,3,23,109,0.17733333333333334,0
MTURK,49e7482b6cda157f388c73b3bcc2ebfc,3WGCNLZJLIW5F0XGEBL4WNPXAIWD14,0.14,6.0,Dimitrios Papadopoulos,420,45,112,17,66,28,46,0.17733333333333334,0
MTURK,49e7482b6cda157f388c73b3bcc2ebfc,3GVPRXWRQKI0YXS4V53OOUWN5947IX,0.14,6.0,Dimitrios Papadopoulos,420,31,128,12,9,19,119,0.1826666666666667,0
MTURK,49e7482b6cda157f388c73b3bcc2ebfc,3G4VVJO6PZGBPAKEEJG7KQF0VX4KP8,0.01,700.0,zhou yu,600,73,211,41,90,32,121,0.013516666666666666,1
MTURK,49e7482b6cda157f388c73b3bcc2ebfc,311HQEI8RT4J9H9F9SJHNQ30S1Z7ZW,0.01,31.0,MLDataLabeler,300,42,62,36,50,6,12,0.012066666666666667,1
MTURK,49e7482b6cda157f388c73b3bcc2ebfc,3LOJFQ4BOXF20DHO9APCKWYBHE1KDU,0.01,700.0,zhou yu,600,59,74,47,58,12,16,0.011233333333333333,1
MTURK,49e7482b6cda157f388c73b3bcc2ebfc,391FPZIE4CMXFPR2PKC4H4M7BXSHUX,0.01,700.0,zhou yu,600,48,74,39,63,9,11,0.011233333333333333,1
MTURK,49e7482b6cda157f388c73b3bcc2ebfc,34ZTTGSNK0CA8KMZLMU9O9C3AMYQH2,0.14,1015.0,Dimitrios Papadopoulos,420,15,535,7,24,8,511,0.31833333333333336,0
MTURK,49e7482b6cda157f388c73b3bcc2ebfc,3MQY1YVHT68JPOHSJJUC6GB2Z3FB2T,0.14,986.0,Dimitrios Papadopoulos,420,31,207,12,38,19,169,0.20900000000000002,1
MTURK,49e7482b6cda157f388c73b3bcc2ebfc,3SNR5F7RA5HL7C7EIDHUU4O4RWPIEB,0.14,977.0,Dimitrios Papadopoulos,420,30,121,13,6,17,115,0.18033333333333335,0
MTURK,49e7482b6cda157f388c73b3bcc2ebfc,37SOB9Z0TVLKNFZNEWXB3TCZHBT3LJ,0.14,974.0,Dimitrios Papadopoulos,420,31,117,12,80,19,37,0.17900000000000002,0
MTURK,49e7482b6cda157f388c73b3bcc2ebfc,3C8QQOM6KSPZDIH6ZZ4Y7ZEO0TQLI1,0.14,969.0,Dimitrios Papadopoulos,420,25,77,11,54,14,23,0.16566666666666668,0
MTURK,49e7482b6cda157f388c73b3bcc2ebfc,302U8RURK2PUNO4RAJJWZG87DQLVN9,0.14,965.0,Dimitrios Papadopoulos,420,25,136,15,108,10,28,0.18533333333333335,1
MTURK,49e7482b6cda157f388c73b3bcc2ebfc,3UYRNV2KJWNWCC8E2Q8M72OZ2SL8NI,0.14,955.0,Dimitrios Papadopoulos,420,30,158,20,6,10,152,0.19266666666666668,1
MTURK,49e7482b6cda157f388c73b3bcc2ebfc,34KYK9TV3UWCUNYQDY9IXYO6XXEBSW,0.14,941.0,Dimitrios Papadopoulos,420,21,155,11,15,10,140,0.19166666666666668,1
MTURK,49e7482b6cda157f388c73b3bcc2ebfc,38VTL6WC5D171TTQBUAUCYCF4MNY5V,0.14,932.0,Dimitrios Papadopoulos,420,32,205,12,175,20,30,0.20833333333333337,0
MTURK,49e7482b6cda157f388c73b3bcc2ebfc,39RRBHZ0BXPO4DIAD7UQU3FGN4UVZR,0.14,910.0,Dimitrios Papadopoulos,420,26,140,11,110,15,30,0.1866666666666667,0
MTURK,49e7482b6cda157f388c73b3bcc2ebfc,36FQTHX306F8A6DBNJ8HPQGU5HFB34,0.14,890.0,Dimitrios Papadopoulos,420,30,210,14,150,16,60,0.21000000000000002,1
MTURK,49e7482b6cda157f388c73b3bcc2ebfc,3M7OI89LW1CQHUSZKL2A7DYWXTH6CC,0.14,880.0,Dimitrios Papadopoulos,420,19,165,10,4,9,161,0.195,1
MTURK,49e7482b6cda157f388c73b3bcc2ebfc,30ZKOOGW3ZU7HTU4U1U26MHRPFG1A7,0.14,867.0,Dimitrios Papadopoulos,420,25,146,10,111,15,35,0.18866666666666668,1
MTURK,49e7482b6cda157f388c73b3bcc2ebfc,3K8CQCU3LHP72D4W0TOSLIRLKZONWC,0.14,849.0,Dimitrios Papadopoulos,420,35,180,13,10,22,170,0.2,0
MTURK,49e7482b6cda157f388c73b3bcc2ebfc,36D1BWBEIQPF8FLPA8KLKWMWB2JM2T,0.14,834.0,Dimitrios Papadopoulos,420,32,136,16,11,16,125,0.18533333333333335,1
MTURK,49e7482b6cda157f388c73b3bcc2ebfc,37VUR2VJ7DDVA8R2EFQTCH7FPI1C1K,0.14,824.0,Dimitrios Papadopoulos,420,27,160,14,75,13,85,0.19333333333333336,1
MTURK,49e7482b6cda157f388c73b3bcc2ebfc,3KQC8JMJHFGI1JGXNBIDB1JS0UK3HC,0.14,798.0,Dimitrios Papadopoulos,420,18,177,9,17,9,160,0.199,1
MTURK,49e7482b6cda157f388c73b3bcc2ebfc,3S1WOPCJGJHH2NRK0V2U65344BEEJJ,0.14,792.0,Dimitrios Papadopoulos,420,23,181,13,14,10,167,0.20033333333333336,1
MTURK,49e7482b6cda157f388c73b3bcc2ebfc,32XN26MTY27O6N0QV9FS1VESEZ90LL,0.14,785.0,Dimitrios Papadopoulos,420,22,153,13,4,9,149,0.191,1
MTURK,49e7482b6cda157f388c73b3bcc2ebfc,3G9UA71JWYIWT8CADNOO0VBNIOA7JQ,0.14,778.0,Dimitrios Papadopoulos,420,34,147,19,35,15,112,0.18900000000000003,1
MTURK,49e7482b6cda157f388c73b3bcc2ebfc,3BA7SXOG2MEHRA06VXP3GMT93PA8R6,0.14,764.0,Dimitrios Papadopoulos,420,48,190,13,6,35,184,0.20333333333333337,1
MTURK,49e7482b6cda157f388c73b3bcc2ebfc,3AXFSPQOZTM981RGV6M0ONO4GCTJF6,0.14,674.0,Dimitrios Papadopoulos,420,22,123,12,8,10,115,0.18100000000000002,1
MTURK,49e7482b6cda157f388c73b3bcc2ebfc,3BVS8WK9R3JN09VU8MF4TWIJOZCBI4,0.14,655.0,Dimitrios Papadopoulos,420,21,129,8,8,13,121,0.18300000000000002,1
MTURK,49e7482b6cda157f388c73b3bcc2ebfc,33NOQL7TARNQT1MX5EJG2PV8C6TZ8Q,0.14,642.0,Dimitrios Papadopoulos,420,37,77,13,15,24,62,0.16566666666666668,0
MTURK,49e7482b6cda157f388c73b3bcc2ebfc,3Q2T3FD0PQW4TXH8E8YQ36ROHGJM34,0.14,641.0,Dimitrios Papadopoulos,420,19,114,9,85,10,29,0.17800000000000002,1
MTURK,49e7482b6cda157f388c73b3bcc2ebfc,37YYO3NWIGEFXB10UCFDTDQ6TFSCCA,0.14,639.0,Dimitrios Papadopoulos,420,25,167,15,24,10,143,0.19566666666666668,1
MTURK,49e7482b6cda157f388c73b3bcc2ebfc,33K3E8REXZJ1O6MI4WVV54FX46V8X2,0.14,632.0,Dimitrios Papadopoulos,420,46,159,27,53,19,106,0.193,0
MTURK,49e7482b6cda157f388c73b3bcc2ebfc,3HKIF5DF71LQGPA2KE15HEADLMHG97,0.14,621.0,Dimitrios Papadopoulos,420,32,167,20,22,12,145,0.19566666666666668,1
MTURK,49e7482b6cda157f388c73b3bcc2ebfc,3OPLMF3EV8BRRJSXWFHQC7A5MSKNLJ,0.14,622.0,Dimitrios Papadopoulos,420,40,168,23,5,17,163,0.196,0
MTURK,49e7482b6cda157f388c73b3bcc2ebfc,35XW21VSWJ2O7WK24BYCB1KB9RRSLZ,0.14,608.0,Dimitrios Papadopoulos,420,36,366,12,98,24,268,0.262,0
MTURK,49e7482b6cda157f388c73b3bcc2ebfc,3VMV5CHJ0B3904JGIK6M8EBPFTKGT7,0.14,602.0,Dimitrios Papadopoulos,420,27,110,11,8,16,102,0.1766666666666667,0
MTURK,49e7482b6cda157f388c73b3bcc2ebfc,37SOB9Z0TVLKNFZNEWXB3TCZHBTL31,0.14,586.0,Dimitrios Papadopoulos,420,29,135,17,20,12,115,0.18500000000000003,1
MTURK,49e7482b6cda157f388c73b3bcc2ebfc,3421H3BMAD507R03SKM8ER2TDEY9J4,0.14,590.0,Dimitrios Papadopoulos,420,29,134,20,4,9,130,0.1846666666666667,1
MTURK,49e7482b6cda157f388c73b3bcc2ebfc,3CIS7GGG787QG32ECU68D7CFLRCEUF,0.14,585.0,Dimitrios Papadopoulos,420,23,37,14,5,9,32,0.15233333333333335,0
MTURK,49e7482b6cda157f388c73b3bcc2ebfc,3N7PQ0KLJ8D6H9PVXAA7QYMF8ESE37,0.14,575.0,Dimitrios Papadopoulos,420,41,145,24,14,17,131,0.18833333333333335,0
MTURK,49e7482b6cda157f388c73b3bcc2ebfc,375VMB7D5M7GF6TEMI6AOM6JRKOIDI,0.14,551.0,Dimitrios Papadopoulos,420,35,158,13,13,22,145,0.19266666666666668,0
MTURK,49e7482b6cda157f388c73b3bcc2ebfc,3HYV4299I3KSI6V19R53HFUQO0K8ET,0.14,544.0,Dimitrios Papadopoulos,420,31,172,19,22,12,150,0.19733333333333336,1
MTURK,49e7482b6cda157f388c73b3bcc2ebfc,3R6RZGK0YI0OZN85HLS7GW6EHAQYV3,0.14,538.0,Dimitrios Papadopoulos,420,29,136,20,11,9,125,0.18533333333333335,1
MTURK,49e7482b6cda157f388c73b3bcc2ebfc,3SV8KD29M7GAO2OYE3GJSU4Z76NKZU,0.14,535.0,Dimitrios Papadopoulos,420,50,170,28,15,22,155,0.19666666666666668,0
MTURK,49e7482b6cda157f388c73b3bcc2ebfc,3O71U79SSED8DE2N4NZRBEZ09WHSM1,0.14,535.0,Dimitrios Papadopoulos,420,25,123,15,3,10,120,0.18100000000000002,1
MTURK,49e7482b6cda157f388c73b3bcc2ebfc,3S8A4GJRE6RMG3YZB2XFX5MLI0X6VB,0.14,518.0,Dimitrios Papadopoulos,420,40,145,23,2,17,143,0.18833333333333335,0
MTURK,49e7482b6cda157f388c73b3bcc2ebfc,3CMIQF80HQEUBV2IP335RIND18IQ61,0.14,520.0,Dimitrios Papadopoulos,420,18,115,10,7,8,108,0.17833333333333334,1
MTURK,49e7482b6cda157f388c73b3bcc2ebfc,32CAVSKPDHDRW28206BT6NTLWI8U1C,0.14,514.0,Dimitrios Papadopoulos,420,32,121,22,4,10,117,0.18033333333333335,1
MTURK,49e7482b6cda157f388c73b3bcc2ebfc,3ZRKL6Z1FBR8L461TK1WY9F3DA6GSI,0.14,508.0,Dimitrios Papadopoulos,420,39,140,23,20,16,120,0.1866666666666667,0
MTURK,49e7482b6cda157f388c73b3bcc2ebfc,3L84EBDQ4AQFZ7PCE2D95FGM3XAKK8,0.14,492.0,Dimitrios Papadopoulos,420,19,127,10,6,9,121,0.18233333333333335,1
MTURK,49e7482b6cda157f388c73b3bcc2ebfc,3X0EMNLXFSDUQ9G4QYWO35D2D5MVP5,0.14,479.0,Dimitrios Papadopoulos,420,39,69,23,7,16,62,0.163,0
MTURK,49e7482b6cda157f388c73b3bcc2ebfc,371Q3BEXEKX8CL16JCPLJGV9O00SZJ,0.14,482.0,Dimitrios Papadopoulos,420,19,109,10,7,9,102,0.17633333333333334,1
MTURK,49e7482b6cda157f388c73b3bcc2ebfc,3GONHBMNIYM5EQO1ZFTZ77W3WBIZME,0.14,485.0,Dimitrios Papadopoulos,420,37,156,30,7,7,149,0.192,1
MTURK,49e7482b6cda157f388c73b3bcc2ebfc,3UEBBGULQICIMH2A75QEVPXFXSRUFD,0.14,472.0,Dimitrios Papadopoulos,420,44,251,30,13,14,238,0.22366666666666668,1
MTURK,49e7482b6cda157f388c73b3bcc2ebfc,3MNJFORX9ES112CV64I6ND5ZYBYF5G,0.14,466.0,Dimitrios Papadopoulos,420,27,128,12,5,15,123,0.1826666666666667,0
MTURK,49e7482b6cda157f388c73b3bcc2ebfc,3OKP4QVBQ5L4L8K7CKF5D9LXR4ZGAM,0.14,458.0,Dimitrios Papadopoulos,420,27,122,13,7,14,115,0.1806666666666667,1
MTURK,49e7482b6cda157f388c73b3bcc2ebfc,33Q5P9PUTSAS54CAMQZL4BRR2XEZCW,0.14,456.0,Dimitrios Papadopoulos,420,19,133,9,7,10,126,0.18433333333333335,1
MTURK,49e7482b6cda157f388c73b3bcc2ebfc,32CAVSKPDHDRW28206BT6NTLWI91UK,0.14,436.0,Dimitrios Papadopoulos,420,22,116,13,6,9,110,0.1786666666666667,1
MTURK,49e7482b6cda157f388c73b3bcc2ebfc,3OB6JN3AATDWCZ2APYZML4U4NUZRMD,0.14,417.0,Dimitrios Papadopoulos,420,51,223,29,49,22,174,0.21433333333333338,0
MTURK,49e7482b6cda157f388c73b3bcc2ebfc,3G4VVJO6Q24GAYMSRUIH1W2LX7GKP9,0.14,411.0,Dimitrios Papadopoulos,420,39,235,15,110,24,125,0.21833333333333335,0
MTURK,49e7482b6cda157f388c73b3bcc2ebfc,3QHITW7OZRXVYXELFGKH7NPZXR8QAR,0.14,405.0,Dimitrios Papadopoulos,420,40,132,17,27,23,105,0.18400000000000002,0
MTURK,49e7482b6cda157f388c73b3bcc2ebfc,30EMX9PEWN7DNQ2KJBMBW17WKRNKSP,0.14,401.0,Dimitrios Papadopoulos,420,25,129,11,11,14,118,0.18300000000000002,0
MTURK,49e7482b6cda157f388c73b3bcc2ebfc,338431Z1GO3KC2NM2EEZD8J9IUEROS,0.14,393.0,Dimitrios Papadopoulos,420,21,172,12,9,9,163,0.19733333333333336,1
MTURK,49e7482b6cda157f388c73b3bcc2ebfc,3XEDXEGFY6CDMHI8A93RMV1DPZ4K02,0.14,368.0,Dimitrios Papadopoulos,420,49,379,28,188,21,191,0.26633333333333337,0
MTURK,49e7482b6cda157f388c73b3bcc2ebfc,3SBNLSTU7XT2AWIOMMUWOH99NXQZDW,0.14,366.0,Dimitrios Papadopoulos,420,27,107,11,12,16,95,0.1756666666666667,0
MTURK,49e7482b6cda157f388c73b3bcc2ebfc,38B7Q9C29JTOJWLW81SJ5NXOR8E69V,0.14,326.0,Dimitrios Papadopoulos,420,7,463,5,50,2,413,0.29433333333333334,1
MTURK,49e7482b6cda157f388c73b3bcc2ebfc,3BJKPTD2RFN8EHRTHTSJS9M52FSRTG,1.0,0.0,Lu Li,3600,686,2890,303,363,383,2527,1.8027777777777778,0
MTURK,49e7482b6cda157f388c73b3bcc2ebfc,3XDSWAMB35GJRCBJZUG8DIFNXUUCQG,0.14,286.0,Dimitrios Papadopoulos,420,21,131,12,12,9,119,0.1836666666666667,1
MTURK,49e7482b6cda157f388c73b3bcc2ebfc,3SX4X51T93XSDL1503SDIIUZIQQAO3,0.14,269.0,Dimitrios Papadopoulos,420,42,155,29,8,13,147,0.19166666666666668,1
MTURK,49e7482b6cda157f388c73b3bcc2ebfc,3TTPFEFXDW8HY23F6DGBI4VCALMH6W,0.14,267.0,Dimitrios Papadopoulos,420,32,110,23,6,9,104,0.1766666666666667,1
MTURK,49e7482b6cda157f388c73b3bcc2ebfc,38EHZ67RJPG5N9TW9N5AM0GXLLOMGC,0.14,261.0,Dimitrios Papadopoulos,420,30,128,22,41,8,87,0.1826666666666667,1
MTURK,49e7482b6cda157f388c73b3bcc2ebfc,35A1YQPVGH4LBTEL7CORQAIRE3QI5A,0.14,252.0,Dimitrios Papadopoulos,420,44,120,27,41,17,79,0.18000000000000002,0
MTURK,49e7482b6cda157f388c73b3bcc2ebfc,3T8DUCXY1QUULUW84E0CGXP2BGQ9TA,0.14,242.0,Dimitrios Papadopoulos,420,34,105,18,62,16,43,0.17500000000000002,1
MTURK,49e7482b6cda157f388c73b3bcc2ebfc,3DZKABX20LTBWK70LTAIJ5EVEM8VCS,0.14,235.0,Dimitrios Papadopoulos,420,22,98,13,3,9,95,0.1726666666666667,1
MTURK,49e7482b6cda157f388c73b3bcc2ebfc,3VW0145YM10FEBJXHTQDJD8DDD5JMD,0.14,220.0,Dimitrios Papadopoulos,420,27,132,11,11,16,121,0.18400000000000002,0
MTURK,49e7482b6cda157f388c73b3bcc2ebfc,3FO95NVK6FOZAUFF9VV8XDTAFJHSRQ,0.14,215.0,Dimitrios Papadopoulos,420,19,156,10,15,9,141,0.192,1
MTURK,49e7482b6cda157f388c73b3bcc2ebfc,3FDWKV9VDQQOSRURTSURQFHOUT3MUC,0.14,193.0,Dimitrios Papadopoulos,420,41,124,22,8,19,116,0.18133333333333335,1
MTURK,49e7482b6cda157f388c73b3bcc2ebfc,3KL228NDNYAAXLTTOBSU7NOTWGTKG5,0.14,182.0,Dimitrios Papadopoulos,420,54,121,38,17,16,104,0.18033333333333335,1
MTURK,49e7482b6cda157f388c73b3bcc2ebfc,3WRKFXQBPEVJDHO5IETO17GK98TYI5,0.14,168.0,Dimitrios Papadopoulos,420,33,149,14,3,19,146,0.18966666666666668,0
MTURK,49e7482b6cda157f388c73b3bcc2ebfc,39HYCOOPLR92BPJ57X42GFD08T8DMT,0.14,143.0,Dimitrios Papadopoulos,420,70,454,26,30,44,424,0.29133333333333333,0
MTURK,49e7482b6cda157f388c73b3bcc2ebfc,3R5LWXWHS3WGHLS0NU7JXHWVSP8XG7,0.14,133.0,Dimitrios Papadopoulos,420,31,140,15,14,16,126,0.1866666666666667,1
MTURK,49e7482b6cda157f388c73b3bcc2ebfc,3UYRNV2KJWNWCC8E2Q8M72OZ2SLN8X,0.14,125.0,Dimitrios Papadopoulos,420,27,109,9,74,18,35,0.17633333333333334,0
MTURK,49e7482b6cda157f388c73b3bcc2ebfc,3EN4YVUOVFGQ8NI1V0SMUUOBKHOXJA,0.14,124.0,Dimitrios Papadopoulos,420,29,112,11,11,18,101,0.17733333333333334,0
MTURK,49e7482b6cda157f388c73b3bcc2ebfc,3909MD9T3251XL5OH5B9R7BCB4YFEI,0.14,125.0,Dimitrios Papadopoulos,420,26,110,11,19,15,91,0.1766666666666667,0
MTURK,49e7482b6cda157f388c73b3bcc2ebfc,3ZICQFRS4465DXNKE4JTF9SCBF0ZZV,0.14,113.0,Dimitrios Papadopoulos,420,26,161,11,21,15,140,0.19366666666666668,0
MTURK,49e7482b6cda157f388c73b3bcc2ebfc,3RBI0I35YHR4NE6MXBM1X1EVQQX3YB,0.14,104.0,Dimitrios Papadopoulos,420,31,135,13,7,18,128,0.18500000000000003,0
MTURK,49e7482b6cda157f388c73b3bcc2ebfc,3WYZV0QBGM1KQ4KP78F5W65YCCGXBQ,0.14,102.0,Dimitrios Papadopoulos,420,26,120,12,2,14,118,0.18000000000000002,0
MTURK,49e7482b6cda157f388c73b3bcc2ebfc,3QGHA0EA1MO514FZX3JJUNRR3AAWBW,0.14,94.0,Dimitrios Papadopoulos,420,26,153,11,30,15,123,0.191,0
MTURK,49e7482b6cda157f388c73b3bcc2ebfc,3W31J70BBVKXG9DOMPWBHW3EYO1CKN,0.14,88.0,Dimitrios Papadopoulos,420,29,151,10,10,19,141,0.19033333333333335,0
MTURK,49e7482b6cda157f388c73b3bcc2ebfc,39XCQ6V3L1S5I9JK5BF2T7SM5CV654,0.14,77.0,Dimitrios Papadopoulos,420,22,154,9,0,13,154,0.19133333333333336,0
MTURK,49e7482b6cda157f388c73b3bcc2ebfc,3OKP4QVBQ5L4L8K7CKF5D9LXR4ZAGG,0.14,72.0,Dimitrios Papadopoulos,420,39,145,14,98,25,47,0.18833333333333335,0
MTURK,49e7482b6cda157f388c73b3bcc2ebfc,3P4C70TRNU5LHRBB9B4VMN18LGYLG9,0.14,68.0,Dimitrios Papadopoulos,420,34,88,11,37,23,51,0.16933333333333334,0
MTURK,49e7482b6cda157f388c73b3bcc2ebfc,3RTFSSG7UBUHED1BOG8D8QNWF4OWLJ,0.14,66.0,Dimitrios Papadopoulos,420,34,112,14,85,20,27,0.17733333333333334,0
MTURK,49e7482b6cda157f388c73b3bcc2ebfc,30OITAWPCTR4GL5D4KJN2EME0MUH97,0.14,55.0,Dimitrios Papadopoulos,420,33,176,13,142,20,34,0.19866666666666669,0
MTURK,49e7482b6cda157f388c73b3bcc2ebfc,30P8I9JKPL9QXZYL6JNA5Z8LM5MV5K,0.14,53.0,Dimitrios Papadopoulos,420,29,131,11,25,18,106,0.1836666666666667,0
MTURK,49e7482b6cda157f388c73b3bcc2ebfc,3FVBZG9CMM2MKRH04O0U93LLXI00HE,0.14,44.0,Dimitrios Papadopoulos,420,34,98,14,12,20,86,0.1726666666666667,0
MTURK,49e7482b6cda157f388c73b3bcc2ebfc,3N2YPY1GJ9MQTIREHKGD9TEYZYKVEK,0.14,45.0,Dimitrios Papadopoulos,420,19,122,10,3,9,119,0.1806666666666667,1
MTURK,49e7482b6cda157f388c73b3bcc2ebfc,3PGQRAZX15887VR1NQN259M7I6WSYS,0.14,34.0,Dimitrios Papadopoulos,420,44,135,16,5,28,130,0.18500000000000003,0
MTURK,49e7482b6cda157f388c73b3bcc2ebfc,363A7XIFW7AN35A21FERDAO7EJNAV5,0.14,32.0,Dimitrios Papadopoulos,420,37,153,20,36,17,117,0.191,1
MTURK,49e7482b6cda157f388c73b3bcc2ebfc,371QPA24D5CCWPTD01LJ1R7JD421TT,0.14,26.0,Dimitrios Papadopoulos,420,26,106,12,7,14,99,0.17533333333333334,0
MTURK,49e7482b6cda157f388c73b3bcc2ebfc,378G7J1SKOM387RJ7UL9VVXC67NEWE,0.14,34.0,Dimitrios Papadopoulos,420,31,136,12,11,19,125,0.18533333333333335,0
MTURK,49e7482b6cda157f388c73b3bcc2ebfc,3LXX8KJXQZXE82R08XEDMNJFC889ON,0.14,34.0,Dimitrios Papadopoulos,420,27,129,11,15,16,114,0.18300000000000002,0
MTURK,49e7482b6cda157f388c73b3bcc2ebfc,3AA88CN99SRAJCETIHE0ENVX1CIYKG,0.14,29.0,Dimitrios Papadopoulos,420,21,111,12,92,9,19,0.17700000000000002,1
MTURK,49e7482b6cda157f388c73b3bcc2ebfc,3ZLW647WBOJEMTDF4QF6OXDQBB232U,0.14,6.0,Dimitrios Papadopoulos,420,33,187,13,15,20,172,0.20233333333333337,0
MTURK,49e7482b6cda157f388c73b3bcc2ebfc,3W5PY7V3VSVF8S8B0WEOD8VKMNIYJH,0.14,9.0,Dimitrios Papadopoulos,420,35,122,12,0,23,122,0.1806666666666667,0
MTURK,49e7482b6cda157f388c73b3bcc2ebfc,307L9TDWJY2PUX2VSRLIJI699O2N3Q,0.06,122.0,Fashion Product Matching,900,30,230,20,188,10,42,0.07533333333333334,1
MTURK,49e7482b6cda157f388c73b3bcc2ebfc,3Q9SPIIRWJWF1CAUT7RF29X68AZAW1,0.06,516.0,Fashion Product Matching,900,20,149,14,130,6,19,0.06993333333333333,1
MTURK,49e7482b6cda157f388c73b3bcc2ebfc,3Y7LTZE0YTW3AGTXAZSD1E3IWFVUZN,0.06,593.0,Fashion Product Matching,900,42,106,20,75,22,31,0.06706666666666666,1
MTURK,49e7482b6cda157f388c73b3bcc2ebfc,3OPLMF3EU5X6A1SKYXPIF40Q9ATLN2,0.06,764.0,Fashion Product Matching,900,48,213,16,157,32,56,0.0742,1
MTURK,49e7482b6cda157f388c73b3bcc2ebfc,3HO4MYYR25CM3O9Z6CNA1JK24UA6UA,0.14,1528.0,Dimitrios Papadopoulos,420,41,166,12,10,29,156,0.19533333333333336,1
MTURK,49e7482b6cda157f388c73b3bcc2ebfc,32W3UF2E0R9C27OL1X9VAFEI13X4CD,0.14,1530.0,Dimitrios Papadopoulos,420,77,218,30,18,47,200,0.21266666666666667,1
MTURK,49e7482b6cda157f388c73b3bcc2ebfc,3YOAVL4CB35PA0ZVTBT3LDF3ALJ4ZC,0.14,1533.0,Dimitrios Papadopoulos,420,37,156,13,3,24,153,0.192,0
MTURK,49e7482b6cda157f388c73b3bcc2ebfc,3R0WOCG22PXLOXOEGZVO7PUULGWUDP,0.14,1513.0,Dimitrios Papadopoulos,420,55,209,17,16,38,193,0.2096666666666667,1
MTURK,49e7482b6cda157f388c73b3bcc2ebfc,3Z33IC0JD3A9YM0X990RHFDN82QV9Y,0.14,1508.0,Dimitrios Papadopoulos,420,27,165,11,24,16,141,0.195,0
MTURK,49e7482b6cda157f388c73b3bcc2ebfc,31GN6YMHMSG4IQW18P5EKC1R7ZHWSK,0.14,1496.0,Dimitrios Papadopoulos,420,22,151,8,1,14,150,0.19033333333333335,0
MTURK,49e7482b6cda157f388c73b3bcc2ebfc,38EHZ67RJPG5N9TW9N5AM0GXLM9MGZ,0.14,1484.0,Dimitrios Papadopoulos,420,32,190,17,47,15,143,0.20333333333333337,1
MTURK,49e7482b6cda157f388c73b3bcc2ebfc,3YLTXLH3EIUP88LKL9FKO4MT5RYHPQ,0.14,1486.0,Dimitrios Papadopoulos,420,17,124,8,5,9,119,0.18133333333333335,1
MTURK,49e7482b6cda157f388c73b3bcc2ebfc,32CAVSKPDHDRW28206BT6NTLWJTU1Z,0.14,1478.0,Dimitrios Papadopoulos,420,19,152,9,3,10,149,0.19066666666666668,1
MTURK,49e7482b6cda157f388c73b3bcc2ebfc,3RTFSSG7UBUHED1BOG8D8QNWF59LWV,0.14,1461.0,Dimitrios Papadopoulos,420,24,146,10,109,14,37,0.18866666666666668,0
MTURK,49e7482b6cda157f388c73b3bcc2ebfc,3K2CEDRADEP9SEF2TN4HLJVMBGHMT8,0.14,1451.0,Dimitrios Papadopoulos,420,26,155,11,13,15,142,0.19166666666666668,0
MTURK,49e7482b6cda157f388c73b3bcc2ebfc,3NI0WFPPJC46N2XJ859QCCWVO56061,0.14,1431.0,Dimitrios Papadopoulos,420,35,190,14,24,21,166,0.20333333333333337,0
MTURK,49e7482b6cda157f388c73b3bcc2ebfc,34D9ZRXCZUI7BDTY7K9M2N40FGFASO,0.14,1395.0,Dimitrios Papadopoulos,420,42,298,22,82,20,216,0.23933333333333334,1
MTURK,49e7482b6cda157f388c73b3bcc2ebfc,3J9L0X0VEIAMDB02ZJ5N3HW1FBT9WN,0.14,1376.0,Dimitrios Papadopoulos,420,18,217,9,162,9,55,0.21233333333333337,1
MTURK,49e7482b6cda157f388c73b3bcc2ebfc,3ZXNP4Z3AU92OY0AG801GAOFME17LG,0.14,1225.0,Dimitrios Papadopoulos,420,23,144,8,3,15,141,0.18800000000000003,0
MTURK,49e7482b6cda157f388c73b3bcc2ebfc,3IZPORCT2IXAKL1ZY1J9TZM869MHRI,0.14,1229.0,Dimitrios Papadopoulos,420,19,186,10,16,9,170,0.202,1
MTURK,49e7482b6cda157f388c73b3bcc2ebfc,3SA4EMRVKYQEX8FON18ZICNCJAVP0V,0.14,1193.0,Dimitrios Papadopoulos,420,51,302,16,43,35,259,0.2406666666666667,1
MTURK,49e7482b6cda157f388c73b3bcc2ebfc,3TRB893CTMYM26M95H3L3IJ7QXF7GA,0.14,1186.0,Dimitrios Papadopoulos,420,26,197,14,23,12,174,0.2056666666666667,1
MTURK,49e7482b6cda157f388c73b3bcc2ebfc,3H5TOKO3EC7NMQFKR6WSOFM85HM64N,0.14,1166.0,Dimitrios Papadopoulos,420,43,223,14,38,29,185,0.21433333333333338,1
MTURK,49e7482b6cda157f388c73b3bcc2ebfc,3YD0MU1ND5PLSF96JHBB7W84S22A71,0.14,1096.0,Dimitrios Papadopoulos,420,18,255,8,19,10,236,0.22500000000000003,1
MTURK,49e7482b6cda157f388c73b3bcc2ebfc,3XABXM4AK4THF9L6II03BWJ474UQ8B,0.14,1065.0,Dimitrios Papadopoulos,420,49,359,14,45,35,314,0.2596666666666667,1
MTURK,49e7482b6cda157f388c73b3bcc2ebfc,3R5OYNIC3FXFDHCFL3W92NPHGLTTPC,0.14,1046.0,Dimitrios Papadopoulos,420,19,125,9,6,10,119,0.1816666666666667,1
MTURK,49e7482b6cda157f388c73b3bcc2ebfc,3OEWW2KGRMZQBS4HKDJF8J253U9DOW,0.14,1025.0,Dimitrios Papadopoulos,420,18,155,9,23,9,132,0.19166666666666668,1
MTURK,49e7482b6cda157f388c73b3bcc2ebfc,3KA7IJSNX9TFHVIYLH5O2TJVAESPBH,0.14,1009.0,Dimitrios Papadopoulos,420,28,149,14,12,14,137,0.18966666666666668,1
MTURK,49e7482b6cda157f388c73b3bcc2ebfc,3BFNCI9LZNEL8UALA2W1KOUYMSA37Y,0.14,997.0,Dimitrios Papadopoulos,420,33,181,19,41,14,140,0.20033333333333336,1
MTURK,49e7482b6cda157f388c73b3bcc2ebfc,3VLL1PIEOTCTET9DCV8CZBL8RCJOZ6,0.14,982.0,Dimitrios Papadopoulos,420,19,128,11,6,8,122,0.1826666666666667,1
MTURK,49e7482b6cda157f388c73b3bcc2ebfc,3VCK0Q0PP82EUN3B7MV7ENIHJVV0NB,0.14,963.0,Dimitrios Papadopoulos,420,33,135,14,6,19,129,0.18500000000000003,1
MTURK,49e7482b6cda157f388c73b3bcc2ebfc,3ACRLU861Q2BK4T8C3PD8HKRW7REBM,0.14,954.0,Dimitrios Papadopoulos,420,55,181,12,8,43,173,0.20033333333333336,1
MTURK,49e7482b6cda157f388c73b3bcc2ebfc,3Y3CZJSZANHY4SH4XZI042JI10VR5B,0.14,918.0,Dimitrios Papadopoulos,420,16,145,7,6,9,139,0.18833333333333335,1
MTURK,49e7482b6cda157f388c73b3bcc2ebfc,3SNR5F7RA5HL7C7EIDHUU4O4RXBIEZ,0.14,909.0,Dimitrios Papadopoulos,420,18,143,10,104,8,39,0.18766666666666668,1
MTURK,49e7482b6cda157f388c73b3bcc2ebfc,3B9XR6P1XHJJVKF0Q4045XXJ1FNJBC,0.14,891.0,Dimitrios Papadopoulos,420,33,158,11,1,22,157,0.19266666666666668,0
MTURK,49e7482b6cda157f388c73b3bcc2ebfc,329E6HTMTZQ939H5TWLAOTZKSC9K3K,0.14,876.0,Dimitrios Papadopoulos,420,19,156,8,39,11,117,0.192,0
MTURK,49e7482b6cda157f388c73b3bcc2ebfc,3UAU495MJLGCSUF36894IJ6TPU4UON,0.14,841.0,Dimitrios Papadopoulos,420,26,159,14,124,12,35,0.193,1
MTURK,49e7482b6cda157f388c73b3bcc2ebfc,3XQ4XW3OEC0I6AYUU5G7W5L23SNS2Z,0.14,839.0,Dimitrios Papadopoulos,420,17,150,8,5,9,145,0.19000000000000003,1
MTURK,49e7482b6cda157f388c73b3bcc2ebfc,337F8MIIN21S8FT5PHGBFECHSE140L,0.14,813.0,Dimitrios Papadopoulos,420,23,161,11,21,12,140,0.19366666666666668,1
MTURK,49e7482b6cda157f388c73b3bcc2ebfc,3E24UO25R2ERQJP2AQB12DSDM8MO6F,0.14,798.0,Dimitrios Papadopoulos,420,18,138,9,14,9,124,0.18600000000000003,1
MTURK,49e7482b6cda157f388c73b3bcc2ebfc,3UY4PIS8RU9E1COT35Z7SS1RON0N10,0.14,781.0,Dimitrios Papadopoulos,420,18,123,9,9,9,114,0.18100000000000002,1
MTURK,49e7482b6cda157f388c73b3bcc2ebfc,360ZO6N6K47Q8Z6OVHZ0UJUAH9F9MW,0.14,763.0,Dimitrios Papadopoulos,420,24,135,12,105,12,30,0.18500000000000003,1
MTURK,49e7482b6cda157f388c73b3bcc2ebfc,3WGCNLZJLIW5F0XGEBL4WNPXAJ01DY,0.14,534.0,Dimitrios Papadopoulos,420,48,236,13,22,35,214,0.21866666666666668,0
MTURK,49e7482b6cda157f388c73b3bcc2ebfc,3UOMW19E7GUUYQSLF2S5F7KW1ZT5CK,0.14,515.0,Dimitrios Papadopoulos,420,35,399,14,134,21,265,0.273,0
MTURK,49e7482b6cda157f388c73b3bcc2ebfc,3R6RZGK0YI0OZN85HLS7GW6EHBCVYO,0.14,486.0,Dimitrios Papadopoulos,420,19,77,8,42,11,35,0.16566666666666668,0
MTURK,49e7482b6cda157f388c73b3bcc2ebfc,3MG8450X3RYUDUR4L8MJ7JBJZZZUP3,0.14,282.0,Dimitrios Papadopoulos,420,150,440,5,3,145,437,0.28666666666666674,1
MTURK,49e7482b6cda157f388c73b3bcc2ebfc,3PKJ68EHEQKTMXIMQWA0R80HWSSJHS,0.14,278.0,Dimitrios Papadopoulos,420,15,34,6,3,9,31,0.15133333333333335,0
MTURK,49e7482b6cda157f388c73b3bcc2ebfc,3ZUE82NE1DPKOKVX42P9ZXFQ02M8F0,0.14,270.0,Dimitrios Papadopoulos,420,33,126,13,7,20,119,0.18200000000000002,0
MTURK,49e7482b6cda157f388c73b3bcc2ebfc,3UYRNV2KJWNWCC8E2Q8M72OZ2T78N6,0.14,266.0,Dimitrios Papadopoulos,420,27,131,12,6,15,125,0.1836666666666667,0
MTURK,49e7482b6cda157f388c73b3bcc2ebfc,3WPCIUYH2DW6OK9PGU5E2T8S22RDTJ,0.14,262.0,Dimitrios Papadopoulos,420,27,111,11,83,16,28,0.17700000000000002,0
MTURK,49e7482b6cda157f388c73b3bcc2ebfc,308KJXFUKUU8QD6DWKECCS0MHZUATE,0.14,247.0,Dimitrios Papadopoulos,420,38,171,12,8,26,163,0.197,1
MTURK,49e7482b6cda157f388c73b3bcc2ebfc,36KM3FWE4U0PR2BORFEIIQWRJGR708,0.14,231.0,Dimitrios Papadopoulos,420,18,137,9,105,9,32,0.1856666666666667,1
MTURK,49e7482b6cda157f388c73b3bcc2ebfc,3P4C70TRNU5LHRBB9B4VMN18LHKGLS,0.14,218.0,Dimitrios Papadopoulos,420,27,174,13,134,14,40,0.198,1
MTURK,49e7482b6cda157f388c73b3bcc2ebfc,3MGHRFQY3OD86M7PEO4IV3GONFYY0Y,0.14,214.0,Dimitrios Papadopoulos,420,23,131,11,10,12,121,0.1836666666666667,1
MTURK,49e7482b6cda157f388c73b3bcc2ebfc,3OKP4QVBQ5L4L8K7CKF5D9LXR5MGAB,0.14,204.0,Dimitrios Papadopoulos,420,24,120,9,1,15,119,0.18000000000000002,0
MTURK,49e7482b6cda157f388c73b3bcc2ebfc,3UDTAB6HI9NT5LZH6CC2WMNXE6E09C,0.14,192.0,Dimitrios Papadopoulos,420,33,148,12,91,21,57,0.18933333333333335,0
MTURK,49e7482b6cda157f388c73b3bcc2ebfc,3QHITW7OZRXVYXELFGKH7NPZXSVAQ0,0.14,184.0,Dimitrios Papadopoulos,420,41,141,17,102,24,39,0.18700000000000003,0
MTURK,49e7482b6cda157f388c73b3bcc2ebfc,3IQ9O0AYX9NNWVPB886PTQO5U7ZITQ,0.14,187.0,Dimitrios Papadopoulos,420,27,129,12,11,15,118,0.18300000000000002,0
MTURK,49e7482b6cda157f388c73b3bcc2ebfc,3B6F54KMS50BHPGYB1GTRMBXBMA1SS,0.14,181.0,Dimitrios Papadopoulos,420,26,148,11,102,15,46,0.18933333333333335,0
MTURK,49e7482b6cda157f388c73b3bcc2ebfc,37SDSEDIOCQTY51PX3AOAVBWZS281Y,0.14,165.0,Dimitrios Papadopoulos,420,22,162,12,8,10,154,0.194,1
MTURK,49e7482b6cda157f388c73b3bcc2ebfc,3DQYSJDTZOZIX7W9HZHVXEBJFAEXED,0.14,162.0,Dimitrios Papadopoulos,420,26,219,11,23,15,196,0.21300000000000002,0
MTURK,49e7482b6cda157f388c73b3bcc2ebfc,3KVQ0UJWQ093COYQWTS6R1RZTFAW5J,0.14,131.0,Dimitrios Papadopoulos,420,28,198,14,27,14,171,0.20600000000000002,1
MTURK,49e7482b6cda157f388c73b3bcc2ebfc,35NNO802BYKP1IKRBCKDKRID5PDINP,0.14,117.0,Dimitrios Papadopoulos,420,32,222,12,4,20,218,0.21400000000000002,0
MTURK,49e7482b6cda157f388c73b3bcc2ebfc,3H6W48L9G7D75YG9G81KP7WGKFAPWX,0.14,117.0,Dimitrios Papadopoulos,420,32,156,12,9,20,147,0.192,0
MTURK,49e7482b6cda157f388c73b3bcc2ebfc,36FQTHX306F8A6DBNJ8HPQGU5I13BK,0.14,113.0,Dimitrios Papadopoulos,420,26,147,11,114,15,33,0.18900000000000003,0
MTURK,49e7482b6cda157f388c73b3bcc2ebfc,3JTPR5MT0V0CHO497F933QX46825KX,0.14,109.0,Dimitrios Papadopoulos,420,30,135,12,92,18,43,0.18500000000000003,0
MTURK,49e7482b6cda157f388c73b3bcc2ebfc,3QX22DUVPR5O56JRYI4WM1J781XMVO,0.14,108.0,Dimitrios Papadopoulos,420,23,149,10,47,13,102,0.18966666666666668,0
MTURK,49e7482b6cda157f388c73b3bcc2ebfc,3A3KKYU7Q651KVJWOS9S832LFA0WM9,0.14,104.0,Dimitrios Papadopoulos,420,29,128,11,14,18,114,0.1826666666666667,0
MTURK,49e7482b6cda157f388c73b3bcc2ebfc,3O0M2G5VD9QA49HIPDZ48PDAVIV49X,0.14,101.0,Dimitrios Papadopoulos,420,28,269,11,126,17,143,0.22966666666666669,1
MTURK,49e7482b6cda157f388c73b3bcc2ebfc,33KMQD9OGM239DB8CEZRX56ERUX778,0.14,99.0,Dimitrios Papadopoulos,420,26,131,11,96,15,35,0.1836666666666667,0
MTURK,49e7482b6cda157f388c73b3bcc2ebfc,3NFWQRSHWH2ZHZ1FN01XRAWOOLZGFO,0.14,98.0,Dimitrios Papadopoulos,420,20,155,11,10,9,145,0.19166666666666668,1
MTURK,49e7482b6cda157f388c73b3bcc2ebfc,3K1H3NEY8ON2JFNJWU673AT3C8JDGA,0.14,89.0,Dimitrios Papadopoulos,420,32,123,13,12,19,111,0.18100000000000002,0
MTURK,49e7482b6cda157f388c73b3bcc2ebfc,3EPG8DX9MNEDSF1PK7EBZ7J30I85PY,0.14,91.0,Dimitrios Papadopoulos,420,28,121,12,8,16,113,0.18033333333333335,0
MTURK,49e7482b6cda157f388c73b3bcc2ebfc,3C8QQOM6KSPZDIH6ZZ4Y7ZEO0UDILN,0.14,90.0,Dimitrios Papadopoulos,420,20,133,8,8,12,125,0.18433333333333335,0
MTURK,49e7482b6cda157f388c73b3bcc2ebfc,3CKVGCS3QJTBA0VGFICTDHSN6U3S0F,0.14,88.0,Dimitrios Papadopoulos,420,34,158,14,11,20,147,0.19266666666666668,0
MTURK,49e7482b6cda157f388c73b3bcc2ebfc,38XPGNCKIWO81GULSE400727MAD4VC,0.14,88.0,Dimitrios Papadopoulos,420,27,126,12,8,15,118,0.18200000000000002,0
MTURK,49e7482b6cda157f388c73b3bcc2ebfc,32TZXEA1PO8SF4ENL0KBTJVRX6714L,0.14,90.0,Dimitrios Papadopoulos,420,56,150,19,10,37,140,0.19000000000000003,0
MTURK,49e7482b6cda157f388c73b3bcc2ebfc,37PGLWGSKWUOTCZOEZSXSZ19BU8IKK,0.14,88.0,Dimitrios Papadopoulos,420,48,24104,9,5,39,24099,8.174666666666669,0
MTURK,6c418c234637a262f4b3cc8fbb2ab683,34F34TZU7WUWU3S1HOFMFVX4GBE2JE,0.07,0.0,Upside Services Inc,3600,154,1229,88,251,66,978,0.09389722222222223,1
MTURK,6c418c234637a262f4b3cc8fbb2ab683,3W9XHF7WGLV68SQR2YVUGGPI6QVTK3,2.0,1.0,HCI Lab,7200,77,792,25,36,52,756,2.22,1
MTURK,6c418c234637a262f4b3cc8fbb2ab683,3G3AJKPCXLTIRYQNU04ZPVANVRTY43,0.08,9.0,Panel,7200,238,1379,134,262,104,1117,0.09532222222222222,0
MTURK,6c418c234637a262f4b3cc8fbb2ab683,36AZSFEYZ41L83GR44R2QACZN2VBV0,0.08,9.0,Panel,7200,238,1379,134,262,104,1117,0.09532222222222222,0
MTURK,6c418c234637a262f4b3cc8fbb2ab683,3EQVJH0T40GUNWROC3WX45QF3WNHTG,0.07,0.0,Upside Services Inc,3600,118,1019,58,142,60,877,0.0898138888888889,1
MTURK,6c418c234637a262f4b3cc8fbb2ab683,3XU80RHWHZH2TRC35TGS966G0R5441,0.08,9.0,Panel,7200,154,450,106,177,48,273,0.085,0
MTURK,6c418c234637a262f4b3cc8fbb2ab683,3RIHDBQ1NEZC9TP4Q407PPWKRNAHMT,0.08,14.0,Panel,7200,149,150,84,19,65,131,0.08166666666666667,0
MTURK,6c418c234637a262f4b3cc8fbb2ab683,3S829FDFT226RPJ6IFJQ9LXK6Z5DX4,0.08,14.0,Panel,7200,59,29,30,5,29,24,0.08032222222222223,0
MTURK,6c418c234637a262f4b3cc8fbb2ab683,3NBFJK3IOHJM90F5JEX2WT9O7NGGOC,0.08,22.0,Panel,7200,48,102,27,27,21,75,0.08113333333333334,1
MTURK,6c418c234637a262f4b3cc8fbb2ab683,3AA88CN98P4350FQFSRFWCZJSETKYR,0.08,11.0,Panel,7200,77,90,44,72,33,18,0.081,0
MTURK,6c418c234637a262f4b3cc8fbb2ab683,3NKW03WTLM8LRYILDWTO71QCGCOQWT,0.08,1.0,Panel,7200,113,240,66,115,47,125,0.08266666666666667,0
MTURK,6c418c234637a262f4b3cc8fbb2ab683,3VQTAXTYN3MLVORRZEHXUOAG9WDBU4,0.08,1.0,Panel,7200,33,90,23,118,10,-28,0.081,0
MTURK,6c418c234637a262f4b3cc8fbb2ab683,372AGES0I460SZ2B0GEAEAEOL0UXRS,0.08,1.0,Panel,7200,74,150,23,29,51,121,0.08166666666666667,0
MTURK,6c418c234637a262f4b3cc8fbb2ab683,34YWR3PJ28BCS5IC63VVUED1CAY0X0,0.08,1.0,Panel,7200,56,120,23,28,33,92,0.08133333333333334,0
MTURK,6c418c234637a262f4b3cc8fbb2ab683,3EHVO81VN5MFD43FXIH95X8HTCM1HC,0.08,0.0,Panel,7200,52,239,25,37,27,202,0.08265555555555555,1
MTURK,6c418c234637a262f4b3cc8fbb2ab683,33KGGVH24UICZU3U2MZV8JWBH251X5,0.08,0.0,Panel,7200,80,240,47,48,33,192,0.08266666666666667,0
MTURK,6c418c234637a262f4b3cc8fbb2ab683,34F34TZU7W0ITVG14MK8MTY1Y9NJ2X,0.08,0.0,Panel,7200,52,90,34,38,18,52,0.081,0
MTURK,6c418c234637a262f4b3cc8fbb2ab683,3X2YVV51PU5XAUY4SH3960I48ZA1WL,0.08,1.0,Panel,7200,85,89,42,69,43,20,0.08098888888888889,0
MTURK,6c418c234637a262f4b3cc8fbb2ab683,3UQ1LLR26A3RUWB5XOKE1STUWODLA8,0.07,0.0,Upside Services Inc,3600,270,2492,100,763,170,1729,0.11845555555555556,1
MTURK,6c418c234637a262f4b3cc8fbb2ab683,3D17ECOUOEW0JWWGIXS71377A74135,0.08,0.0,Panel,7200,364,3424,176,1618,188,1806,0.11804444444444445,0
MTURK,6c418c234637a262f4b3cc8fbb2ab683,3K3G488TR29REF31HV6FH1DZWEMQ5C,0.08,0.0,Panel,7200,390,3420,188,1592,202,1828,0.118,0
MTURK,6c418c234637a262f4b3cc8fbb2ab683,32FESTC2NHR45TJXDEDS58GYRHBCUA,0.08,0.0,Panel,7200,318,2279,179,1503,139,776,0.10532222222222223,0
MTURK,6c418c234637a262f4b3cc8fbb2ab683,3IJ95K7NDX7ISNRTV1S3A68MZEQGNH,0.07,0.0,Upside Services Inc,3600,147,1919,103,1377,44,542,0.1073138888888889,1
MTURK,6c418c234637a262f4b3cc8fbb2ab683,3VDVA3ILIDG1D884DCZRKXWGECE1GI,0.08,0.0,Panel,7200,204,1406,147,1890,57,-484,0.09562222222222222,0
MTURK,6c418c234637a262f4b3cc8fbb2ab683,3T5ZXGO9DEPPLTNQOJDV65KUXEUZQU,0.08,0.0,Panel,7200,155,389,102,306,53,83,0.08432222222222223,0
MTURK,6c418c234637a262f4b3cc8fbb2ab683,3ZQX1VYFTD67GL9N0GLE4GSQJ4IO8J,0.08,0.0,Panel,7200,173,419,111,313,62,106,0.08465555555555555,0
MTURK,6c418c234637a262f4b3cc8fbb2ab683,31KPKEKW4A8JGARBE9YRYJLCB8OB0L,0.07,0.0,Upside Services Inc,3600,214,3479,81,841,133,2638,0.13764722222222223,0
MTURK,6c418c234637a262f4b3cc8fbb2ab683,3YGE63DIN8SB4DPM90UNLXYXL96W0M,0.07,0.0,Upside Services Inc,3600,308,2610,130,1017,178,1593,0.12075000000000001,0
MTURK,6c418c234637a262f4b3cc8fbb2ab683,3WRAAIUSBJXSH6MM8XS6BOMMON8XA5,0.25,0.0,Helen1028,900,62,719,56,697,6,22,0.44972222222222225,1
MTURK,6c418c234637a262f4b3cc8fbb2ab683,3NRZ1LDP7W1IMPYB18TKZ2TNAJMZPM,0.07,0.0,Upside Services Inc,3600,258,1499,145,1048,113,451,0.09914722222222223,0
MTURK,6c418c234637a262f4b3cc8fbb2ab683,3G3AJKPCXLNWS62N72ZDIX9QDTMY43,0.07,0.0,Upside Services Inc,3600,65,300,34,164,31,136,0.07583333333333334,1
MTURK,6c418c234637a262f4b3cc8fbb2ab683,3ACRLU860N9I7065MGX6J8NG59ZEBB,0.07,0.0,Upside Services Inc,3600,169,1289,55,331,114,958,0.09506388888888889,1
MTURK,6c418c234637a262f4b3cc8fbb2ab683,378G7J1SJLTAV34GH7T26M01FAHWE9,0.07,0.0,Upside Services Inc,3600,190,1376,75,348,115,1028,0.09675555555555557,1
MTURK,6c418c234637a262f4b3cc8fbb2ab683,39RRBHZ0AUWVR9V7NK2J5UI5W7OZV8,0.07,0.0,Upside Services Inc,3600,24,28029,2,10,22,28019,0.6150083333333334,1
MTURK,6c418c234637a262f4b3cc8fbb2ab683,3S37Y8CWI81E2TVNFZMB4YP7KL4W4H,0.08,1.0,Panel,7200,76,271,28,74,48,197,0.08301111111111112,0
MTURK,6c418c234637a262f4b3cc8fbb2ab683,3YGYP13641AVG5O7YAR1G8NQJNLRN5,0.08,1.0,Panel,7200,91,270,39,49,52,221,0.083,0
MTURK,6c418c234637a262f4b3cc8fbb2ab683,3GVPRXWRPHVTKLT1SGG36J09WCY7I7,0.08,34.0,Panel,7200,147,448,63,56,84,392,0.08497777777777778,0
MTURK,6c418c234637a262f4b3cc8fbb2ab683,3HA5ODM5KATKPPXTFQDXGZMZRS8VSG,0.08,34.0,Panel,7200,69,299,28,9,41,290,0.08332222222222223,0
MTURK,6c418c234637a262f4b3cc8fbb2ab683,3M93N4X8HKOBYUXZY1ZEDBB5W54JSM,0.08,67.0,Panel,7200,40,133,22,14,18,119,0.08147777777777777,0
MTURK,6c418c234637a262f4b3cc8fbb2ab683,3J6BHNX0U9T9T1BC8QI4FW1COVWNKD,0.08,453.0,Panel,7200,124,1233,42,79,82,1154,0.0937,0
MTURK,6c418c234637a262f4b3cc8fbb2ab683,3YGYP13641AVG5O7YAR1G8NQJNPRN9,0.08,538.0,Panel,7200,164,1236,56,85,108,1151,0.09373333333333334,0
MTURK,6c418c234637a262f4b3cc8fbb2ab683,3ZQA3IO31BSP5LP21VCZP65I5Z1O1Q,0.08,418.0,Panel,7200,202,1320,68,114,134,1206,0.09466666666666668,0
MTURK,6c418c234637a262f4b3cc8fbb2ab683,3YGYP13641AVG5O7YAR1G8NQJNKNR0,0.08,366.0,Panel,7200,202,1201,72,184,130,1017,0.09334444444444445,0
MTURK,6c418c234637a262f4b3cc8fbb2ab683,3R0WOCG21MAEALPBDA83PEYGCITUD0,0.08,324.0,Panel,7200,213,1202,81,108,132,1094,0.09335555555555555,0
MTURK,6c418c234637a262f4b3cc8fbb2ab683,38DCH97KHH3ZLEIM6XA9IBW4EHIQJ3,0.08,324.0,Panel,7200,200,1172,78,102,122,1070,0.09302222222222223,0
MTURK,6c418c234637a262f4b3cc8fbb2ab683,3X55NP42EOH30OFI3Z3X2ZP5DOEP33,0.08,271.0,Panel,7200,216,1112,87,68,129,1044,0.09235555555555555,0
MTURK,6c418c234637a262f4b3cc8fbb2ab683,3T2HW4QDUV86L1VUF3I19CTKEXBC9V,0.08,271.0,Panel,7200,95,122,57,27,38,95,0.08135555555555556,0
MTURK,6c418c234637a262f4b3cc8fbb2ab683,3GMLHYZ0LEYH8WK296VH2Z8HU6WUY5,0.08,187.0,Panel,7200,126,153,74,34,52,119,0.0817,0
MTURK,6c418c234637a262f4b3cc8fbb2ab683,33TGB4G0LPID8EF345J5EPF69M1XTH,0.08,187.0,Panel,7200,69,58,36,20,33,38,0.08064444444444445,0
MTURK,6c418c234637a262f4b3cc8fbb2ab683,3JGHED38EDSFAL86WY26S7UXMVW7YD,0.08,187.0,Panel,7200,41,27,21,10,20,17,0.0803,0
MTURK,6c418c234637a262f4b3cc8fbb2ab683,3JAOYN9IHL3WTZAV516QPWM48SS33B,0.08,3.0,Panel,7200,69,241,28,31,41,210,0.08267777777777778,1
MTURK,6c418c234637a262f4b3cc8fbb2ab683,3I6NF2WGIGX01Q9NEZ13NN9XQTKG5I,0.08,327.0,Panel,7200,130,5699,65,5036,65,663,0.14332222222222224,0
MTURK,6c418c234637a262f4b3cc8fbb2ab683,35ZRNT9RUIZLFO3HOZQIDZKF3JOO3R,0.08,327.0,Panel,7200,90,5399,45,5011,45,388,0.13998888888888888,0
MTURK,6c418c234637a262f4b3cc8fbb2ab683,3MYASTQBG7CMISIUW1OYFD1R9XUDQL,0.08,422.0,Panel,7200,111,5399,57,4988,54,411,0.13998888888888888,0
MTURK,6c418c234637a262f4b3cc8fbb2ab683,3B286OTISEI7YYB5H1DNSBHZAZVAJF,0.08,317.0,Panel,7200,146,5072,81,4724,65,348,0.13635555555555556,0
MTURK,6c418c234637a262f4b3cc8fbb2ab683,3NOEP8XAU43FGMMWNOAL9FE9KJAPXY,0.08,317.0,Panel,7200,146,5042,81,4694,65,348,0.1360222222222222,0
MTURK,6c418c234637a262f4b3cc8fbb2ab683,30EV7DWJTVWW6LU1DOXEMTU1RKQ6YR,0.08,317.0,Panel,7200,145,4772,81,4682,64,90,0.13302222222222224,0
MTURK,6c418c234637a262f4b3cc8fbb2ab683,3EFNPKWBMSP0C7BYMEO7NYOX5G730F,0.08,317.0,Panel,7200,164,4532,90,4386,74,146,0.13035555555555556,0
MTURK,6c418c234637a262f4b3cc8fbb2ab683,3DW3BNF1GHJ265IK1S7SZ8MYFYEV8T,0.08,166.0,Panel,7200,178,4442,100,4255,78,187,0.12935555555555556,0
MTURK,6c418c234637a262f4b3cc8fbb2ab683,3B286OTISEI7YYB5H1DNSBHZAZTAJD,0.08,218.0,Panel,7200,155,212,92,45,63,167,0.08235555555555556,0
MTURK,6c418c234637a262f4b3cc8fbb2ab683,3H1C3QRA01KNGXMBNEYN1QUV5ULEC1,0.08,135.0,Panel,7200,75,59,43,11,32,48,0.08065555555555556,0
MTURK,6c418c234637a262f4b3cc8fbb2ab683,37VUR2VJ6AQOWWSZBQ38U6B1GMH1C7,0.08,135.0,Panel,7200,34,27,20,6,14,21,0.0803,0
MTURK,6c418c234637a262f4b3cc8fbb2ab683,3C8QQOM6JP2SZ6I3WAHDPOIARX5LIY,0.08,268.0,Panel,7200,49,73,34,19,15,54,0.08081111111111111,0
MTURK,6c418c234637a262f4b3cc8fbb2ab683,31GN6YMHLPTX4EXY50IT215DY27SWM,0.08,268.0,Panel,7200,44,60,31,18,13,42,0.08066666666666666,0
MTURK,6c418c234637a262f4b3cc8fbb2ab683,35JDMRECC4A0X92GP0U6RHFA3MGGEG,0.08,283.0,Panel,7200,62,59,37,21,25,38,0.08065555555555556,0
MTURK,6c418c234637a262f4b3cc8fbb2ab683,3BCRDCM0ODV1MG5K99WNDLFQT556KK,0.08,9.0,Panel,7200,140,2580,45,136,95,2444,0.10866666666666666,0
MTURK,6c418c234637a262f4b3cc8fbb2ab683,3XUSYT70IT2YUZDVF3UJ07A9WUF0DV,0.08,9.0,Panel,7200,140,2580,45,136,95,2444,0.10866666666666666,0
MTURK,6c418c234637a262f4b3cc8fbb2ab683,3V0TR1NRVA3HVGSKEUQJM9SGS2O4A1,0.08,9.0,Panel,7200,123,2460,44,136,79,2324,0.10733333333333334,0
MTURK,6c418c234637a262f4b3cc8fbb2ab683,34R3P23QHS28E5JIU66UYNYBPQZWHC,0.08,1.0,Panel,7200,138,2462,53,140,85,2322,0.10735555555555557,0
MTURK,6c418c234637a262f4b3cc8fbb2ab683,3O0M2G5VC633QXIFMOCJQEHWMK949P,0.08,6.0,Panel,7200,171,2550,64,145,107,2405,0.10833333333333334,0
MTURK,6c418c234637a262f4b3cc8fbb2ab683,3NSCTNUR2ZOZRZWKSZ9TR1YUSYJA5C,0.08,3.0,Panel,7200,206,2580,81,151,125,2429,0.10866666666666666,0
MTURK,6c418c234637a262f4b3cc8fbb2ab683,3TLFH2L6Y9PC7YC6GGYCOZLAWDF2TQ,0.08,3.0,Panel,7200,204,2490,81,116,123,2374,0.10766666666666667,0
MTURK,6c418c234637a262f4b3cc8fbb2ab683,3M47JKRKCX2HRF3J0KZKNG6ZY6G688,0.08,5.0,Panel,7200,70,150,16,15,54,135,0.08166666666666667,0
MTURK,6c418c234637a262f4b3cc8fbb2ab683,36AZSFEYZ41L83GR44R2QACZN41BVA,0.08,1.0,Panel,7200,79,90,31,20,48,70,0.081,0
MTURK,6c418c234637a262f4b3cc8fbb2ab683,3HYV4299H0XL4UWY62IIZ4YCF3M8EB,0.08,1.0,Panel,7200,36,29,19,11,17,18,0.08032222222222223,0
MTURK,6c418c234637a262f4b3cc8fbb2ab683,3VDVA3ILIDG1D884DCZRKXWGEE11G9,0.08,7.0,Panel,7200,118,450,21,46,97,404,0.085,0
MTURK,6c418c234637a262f4b3cc8fbb2ab683,3UXQ63NLAANICY4XQ0PW31EXW64LB6,0.08,7.0,Panel,7200,74,300,30,31,44,269,0.08333333333333333,0
MTURK,6c418c234637a262f4b3cc8fbb2ab683,3X55NP42EOH30OFI3Z3X2ZP5DPEP35,0.08,0.0,Panel,7200,117,1501,48,705,69,796,0.09667777777777778,0
MTURK,6c418c234637a262f4b3cc8fbb2ab683,32L724R85LLIQRX1O2AK65RUW6TPIL,0.08,3.0,Panel,7200,143,1471,68,722,75,749,0.09634444444444445,0
MTURK,6c418c234637a262f4b3cc8fbb2ab683,3I7SHAD35MXFG4JSDVEVYC7QDMG7MN,0.08,1.0,Panel,7200,185,1501,84,730,101,771,0.09667777777777778,0
MTURK,6c418c234637a262f4b3cc8fbb2ab683,3UEBBGULPFPB85374G3TDE11OW7FUW,0.08,1.0,Panel,7200,182,1441,84,730,98,711,0.09601111111111112,0
MTURK,6c418c234637a262f4b3cc8fbb2ab683,37SDSEDIN93MKT2MUEN3SKFIQVZ184,0.08,0.0,Panel,7200,209,1471,102,751,107,720,0.09634444444444445,0
MTURK,6c418c234637a262f4b3cc8fbb2ab683,39TX062QX1P89XH9PQDEWCB8FOHX3V,0.08,3.0,Panel,7200,236,1442,117,769,119,673,0.09602222222222223,0
MTURK,6c418c234637a262f4b3cc8fbb2ab683,3SSN80MU8CPE5VPGAW5DDYSAQ9GXKH,0.08,3.0,Panel,7200,198,1290,100,815,98,475,0.09433333333333334,0
MTURK,6c418c234637a262f4b3cc8fbb2ab683,3D1UCPY6GGAIUWG1HI1MGDUFOEC830,0.08,8.0,Panel,7200,223,1350,113,834,110,516,0.095,0
MTURK,6c418c234637a262f4b3cc8fbb2ab683,307L9TDWJYT3X335NKQ5YAKAD9T3N1,0.08,4.0,Panel,7200,284,1351,146,866,138,485,0.09501111111111112,0
MTURK,6c418c234637a262f4b3cc8fbb2ab683,3OND0WXMHWGEX5XR96COCHRBIM8HEV,0.08,4.0,Panel,7200,284,1261,146,866,138,395,0.09401111111111111,0
MTURK,6c418c234637a262f4b3cc8fbb2ab683,3ZQA3IO31BSP5LP21VCZP65I5001O4,0.08,4.0,Panel,7200,284,1172,146,867,138,305,0.09302222222222223,0
MTURK,6c418c234637a262f4b3cc8fbb2ab683,3087LXLJ6MHVSJRR69P9O7DU878F0Y,0.08,4.0,Panel,7200,266,299,150,134,116,165,0.08332222222222223,0
MTURK,6c418c234637a262f4b3cc8fbb2ab683,39WICJI5ATTXESHOQ81ZTXRJNN03ZH,0.08,7.0,Panel,7200,210,239,117,99,93,140,0.08265555555555555,0
MTURK,6c418c234637a262f4b3cc8fbb2ab683,3XABXM4AJ16A1XM3FTDITLNQY6RQ8M,0.08,7.0,Panel,7200,164,180,94,74,70,106,0.082,0
MTURK,6c418c234637a262f4b3cc8fbb2ab683,3HEM8MA6H9DV7PLK1AFTF7IGNHMPQ2,0.08,0.0,Panel,7200,177,179,98,80,79,99,0.08198888888888889,0
MTURK,6c418c234637a262f4b3cc8fbb2ab683,38RHULDV9YG8A0U20OOFYZZQP3BIWO,0.08,1.0,Panel,7200,52,59,14,9,38,50,0.08065555555555556,0
MTURK,6c418c234637a262f4b3cc8fbb2ab683,3UY4PIS8QRM7N0PQ0GCMAH5DFQAN1Q,0.08,0.0,Panel,7200,43,240,20,41,23,199,0.08266666666666667,1
MTURK,6c418c234637a262f4b3cc8fbb2ab683,3UUIU9GZC5646VVTYZ0AM6OMGNIT5U,0.08,1.0,Panel,7200,93,270,37,33,56,237,0.083,0
MTURK,6c418c234637a262f4b3cc8fbb2ab683,3TLFH2L6Y9VKMES9W0S8D7DD8FUT24,3.0,0.0,Edward Gibson,5400,389,3419,107,1110,282,2309,4.899444444444445,1
MTURK,6c418c234637a262f4b3cc8fbb2ab683,3IKDQS3DQE1ZW2OXJXOEM5SNXO8CIQ,0.08,0.0,Panel,7200,507,5220,76,244,431,4976,0.138,1
MTURK,6c418c234637a262f4b3cc8fbb2ab683,388FBO7JZRU4D60TC5JVO4GNMA5NY8,0.08,0.0,Panel,7200,427,4500,40,92,387,4408,0.13,0
MTURK,6c418c234637a262f4b3cc8fbb2ab683,3P458N04Q1IJOFLQLQZ9D26G9ATX2W,0.08,0.0,Panel,7200,398,3300,57,86,341,3214,0.11666666666666667,0
MTURK,6c418c234637a262f4b3cc8fbb2ab683,3J9UN9O9J3TBXLDNPZGU355M1DMJ00,0.08,0.0,Panel,7200,386,3060,57,62,329,2998,0.114,0
MTURK,6c418c234637a262f4b3cc8fbb2ab683,3OKP4QVBP2YX7WL49VSKVYPJI7MGAP,0.08,0.0,Panel,7200,235,450,67,44,168,406,0.085,0
MTURK,6c418c234637a262f4b3cc8fbb2ab683,367O8HRHKG9LVCEEVUCA79MME8NS4D,0.08,0.0,Panel,7200,111,1258,12,13,99,1245,0.09397777777777779,0
MTURK,6c418c234637a262f4b3cc8fbb2ab683,3F6045TU7DP4N3OR3J8A7MSC8C5998,0.08,0.0,Panel,7200,82,690,13,5,69,685,0.08766666666666667,0
MTURK,6c418c234637a262f4b3cc8fbb2ab683,38DCH97KHH3ZLEIM6XA9IBW4EJCQJ1,0.08,20.0,Panel,7200,317,2370,39,139,278,2231,0.10633333333333334,1
MTURK,6c418c234637a262f4b3cc8fbb2ab683,3L60IFZKF3JQHFOTZ7KUXKOOA2JHHU,0.08,0.0,Panel,7200,491,3509,102,325,389,3184,0.1189888888888889,0
MTURK,6c418c234637a262f4b3cc8fbb2ab683,3NKW03WTLM2ZS6ULQYO203PFYENWQ5,0.07,0.0,Upside Services Inc,3600,451,3123,91,317,360,2806,0.130725,1
MTURK,6c418c234637a262f4b3cc8fbb2ab683,3W1K7D6QSBI2HNL151G5BGPVBHQZBL,0.08,13.0,Panel,7200,483,2756,111,341,372,2415,0.11062222222222223,0
MTURK,6c418c234637a262f4b3cc8fbb2ab683,3BDORL6HKKECP1RG9KIN0XTEKL9CRE,0.08,0.0,Panel,7200,452,2610,128,360,324,2250,0.109,0
MTURK,6c418c234637a262f4b3cc8fbb2ab683,3UAU495MIIT5EIG03JMJ08AFGYWUOX,0.08,0.0,Panel,7200,487,2641,143,365,344,2276,0.10934444444444445,0
MTURK,6c418c234637a262f4b3cc8fbb2ab683,3X0EMNLXEPQNCXH1N993LUHO4A3VP6,0.08,0.0,Panel,7200,524,2431,152,336,372,2095,0.10701111111111111,0
MTURK,6c418c234637a262f4b3cc8fbb2ab683,3LN3BXKGC0WUE9O7A0OCDNMAASJGWY,0.08,0.0,Panel,7200,552,2431,157,312,395,2119,0.10701111111111111,0
MTURK,6c418c234637a262f4b3cc8fbb2ab683,375VMB7D4JK91UUBJTJP6BA5IP5DIE,0.08,1.0,Panel,7200,570,2430,165,316,405,2114,0.107,0
MTURK,6c418c234637a262f4b3cc8fbb2ab683,3R5LWXWHR09939TXK5KYF60HJUQGXS,0.08,1.0,Panel,7200,564,2280,165,292,399,1988,0.10533333333333333,0
MTURK,6c418c234637a262f4b3cc8fbb2ab683,3X7837UUADZ6BWZ2ROWBC6FDEI8J65,0.08,0.0,Panel,7200,700,2820,176,320,524,2500,0.11133333333333334,0
MTURK,6c418c234637a262f4b3cc8fbb2ab683,3KLL7H3EGD2VZGJD4W1YCLFXIJWVH4,0.08,0.0,Panel,7200,1051,3630,348,652,703,2978,0.12033333333333333,0
MTURK,6c418c234637a262f4b3cc8fbb2ab683,3LOJFQ4BOXG07PKZJW41JRPIAT2KD4,0.08,0.0,Panel,7200,1016,2730,348,619,668,2111,0.11033333333333334,0
MTURK,6c418c234637a262f4b3cc8fbb2ab683,3QD8LUVX4XZBNC4D3917B99STLH5X4,0.08,2.0,Panel,7200,1046,2760,357,622,689,2138,0.11066666666666666,0
MTURK,6c418c234637a262f4b3cc8fbb2ab683,3CVBMEMMXBHTOQIHMYYI67ZUW1QH7Z,0.08,0.0,Panel,7200,1122,2971,370,678,752,2293,0.11301111111111112,0
MTURK,6c418c234637a262f4b3cc8fbb2ab683,3VW0145YLYD80ZKUE43S12CZ4IIJMA,0.08,0.0,Panel,7200,968,2908,361,734,607,2174,0.11231111111111111,0
MTURK,6c418c234637a262f4b3cc8fbb2ab683,3L84EBDQ3738LVQ9BDQON4K8U2ZKKH,0.08,0.0,Panel,7200,937,2881,347,741,590,2140,0.11201111111111112,0
MTURK,6c418c234637a262f4b3cc8fbb2ab683,3G57RS03HH6AMW1GFKGELJFWGC825I,0.08,0.0,Panel,7200,915,2644,339,690,576,1954,0.10937777777777778,0
MTURK,6c418c234637a262f4b3cc8fbb2ab683,39XCQ6V3KY5Y4XKH2MSHBWW8WHF567,0.08,0.0,Panel,7200,806,2522,308,680,498,1842,0.10802222222222223,0
MTURK,6c418c234637a262f4b3cc8fbb2ab683,3MA5N0ATTC6DH3WQDT454HD6Z8WWKE,0.07,0.0,Upside Services Inc,3600,275,871,128,325,147,546,0.08693611111111112,1
MTURK,6c418c234637a262f4b3cc8fbb2ab683,3PCPFX4U40RJGCWQN7JO3D4CLC8QFB,0.08,0.0,Panel,7200,628,1920,283,647,345,1273,0.10133333333333333,0
MTURK,6c418c234637a262f4b3cc8fbb2ab683,35JDMRECC5SHS0NQU5X2I7CRP94EGA,2.0,0.0,Mia Park,3600,234,686,134,317,100,369,2.381111111111111,0
MTURK,6c418c234637a262f4b3cc8fbb2ab683,37AQKJ12TXP6RX6JZVI8PMU0WS4TTP,0.08,0.0,Panel,7200,491,1500,246,587,245,913,0.09666666666666666,0
MTURK,6c418c234637a262f4b3cc8fbb2ab683,3VI0PC2ZAYLXVMAV8OX6KF9JAGIOXO,0.08,0.0,Panel,7200,489,1410,232,478,257,932,0.09566666666666668,0
MTURK,6c418c234637a262f4b3cc8fbb2ab683,3RIHDBQ1NEZC9TP4Q407PPWKRQEMH8,0.08,0.0,Panel,7200,456,1258,197,363,259,895,0.09397777777777779,0
MTURK,6c418c234637a262f4b3cc8fbb2ab683,37SQU136V7P49TI1VTEODASACQZ11S,0.04,0.0,Panel,7200,477,1709,192,413,285,1296,0.049494444444444445,0
MTURK,6c418c234637a262f4b3cc8fbb2ab683,3E9ZFLPWOYTNZ0ZSATK10IDXY7EXIX,0.08,0.0,Panel,7200,473,1679,192,396,281,1283,0.09865555555555555,0
MTURK,6c418c234637a262f4b3cc8fbb2ab683,3IQ9O0AYW60GIJQ85JJ4BFSRLBTIT2,0.08,4.0,Panel,7200,498,1709,204,395,294,1314,0.09898888888888889,0
MTURK,6c418c234637a262f4b3cc8fbb2ab683,3R16PJFTS3SN7T16QL38GNVCXGZ4K1,0.08,13.0,Panel,7200,473,1561,201,361,272,1200,0.09734444444444444,0
MTURK,6c418c234637a262f4b3cc8fbb2ab683,36818Z1KV3EWDK9GEGL0C40AE483AZ,0.08,0.0,Panel,7200,509,1469,211,305,298,1164,0.09632222222222223,0
MTURK,6c418c234637a262f4b3cc8fbb2ab683,37SOB9Z0SSYD930KB7AQLIGL8GGL38,0.04,0.0,Panel,7200,543,1410,230,255,313,1155,0.04783333333333334,0
MTURK,6c418c234637a262f4b3cc8fbb2ab683,3DW3BNF1GHJ265IK1S7SZ8MYF0B8V7,0.08,5.0,Panel,7200,542,1350,230,226,312,1124,0.095,0
MTURK,6c418c234637a262f4b3cc8fbb2ab683,3D5G8J4N5A5L4PA84QINQ4ILTDPTVA,0.04,2.0,Panel,7200,581,1859,220,202,361,1657,0.05032777777777778,0
MTURK,6c418c234637a262f4b3cc8fbb2ab683,3YKP7CX6G2AXYLRVZ8J0DYVZJNF7B4,0.07,0.0,Upside Services Inc,3600,99,162,42,65,57,97,0.07315,0
MTURK,6c418c234637a262f4b3cc8fbb2ab683,39I4RL8QGJIW530YK00B3VFK5ZS4HU,0.08,0.0,Panel,7200,338,1504,116,100,222,1404,0.09671111111111111,0
MTURK,6c418c234637a262f4b3cc8fbb2ab683,311HQEI8RSHFFBIBSK4P6E3ZSRB7ZJ,0.08,10.0,Panel,7200,385,1411,145,108,240,1303,0.09567777777777778,0
MTURK,6c418c234637a262f4b3cc8fbb2ab683,3W9XHF7WGKW7OEGW5M4GOV74DFJKTG,0.04,0.0,Panel,7200,389,1264,156,99,233,1165,0.04702222222222222,0
MTURK,6c418c234637a262f4b3cc8fbb2ab683,3UUIU9GZC5646VVTYZ0AM6OMGPST58,0.08,0.0,Panel,7200,692,3808,182,207,510,3601,0.12231111111111112,0
MTURK,6c418c234637a262f4b3cc8fbb2ab683,32K26U12DNPEN0EBI0I8L00ZQRDVD5,0.04,0.0,Panel,7200,605,3300,161,712,444,2588,0.058333333333333334,0
MTURK,6c418c234637a262f4b3cc8fbb2ab683,3GITHABACYMECL7MJKC0F0FI7XN2NN,0.08,0.0,Panel,7200,625,3388,174,748,451,2640,0.11764444444444444,0
MTURK,6c418c234637a262f4b3cc8fbb2ab683,3SCKNODZ0XHLYM4SPWTVBRWQIDAN7P,0.08,0.0,Panel,7200,629,3239,179,229,450,3010,0.11598888888888889,0
MTURK,6c418c234637a262f4b3cc8fbb2ab683,38G0E1M85M6042PX4V8XV04NCRBUVH,0.04,1.0,Panel,7200,625,3236,176,230,449,3006,0.05797777777777778,0
MTURK,6c418c234637a262f4b3cc8fbb2ab683,30EMX9PEVKK69E3HGMZQEQBIBWJKS5,0.04,1.0,Panel,7200,667,3417,199,250,468,3167,0.05898333333333333,0
MTURK,6c418c234637a262f4b3cc8fbb2ab683,36U4VBVNQOE8BV8GVB3NU3FKRLWRUJ,0.04,0.0,Panel,7200,879,4288,350,647,529,3641,0.06382222222222222,0
MTURK,6c418c234637a262f4b3cc8fbb2ab683,3M93N4X8HKOBYUXZY1ZEDBB5W7KSJF,0.08,6.0,Panel,7200,863,4347,349,698,514,3649,0.1283,0
MTURK,6c418c234637a262f4b3cc8fbb2ab683,3D1UCPY6GGAIUWG1HI1MGDUFOGS83K,0.08,0.0,Panel,7200,926,4676,378,722,548,3954,0.13195555555555555,0
MTURK,6c418c234637a262f4b3cc8fbb2ab683,3E6L1VR4XWNQ6UD68Y5QX8NLLB76F5,0.04,0.0,Panel,7200,975,4736,415,771,560,3965,0.06631111111111111,0
MTURK,6c418c234637a262f4b3cc8fbb2ab683,3OYHVNTV5TZRBMBO95IHUL1HE7IOKE,0.04,0.0,Panel,7200,1080,5277,461,842,619,4435,0.06931666666666667,0
MTURK,6c418c234637a262f4b3cc8fbb2ab683,3D1TUISJWI1VIW5X5O9EGBET4PHIUA,0.04,1.0,Panel,7200,988,4766,426,779,562,3987,0.06647777777777777,0
MTURK,6c418c234637a262f4b3cc8fbb2ab683,3S4TINXCC0OQIJ7U3S5OVIIRRD9BOH,0.04,0.0,Panel,7200,1122,5366,490,861,632,4505,0.06981111111111112,0
MTURK,6c418c234637a262f4b3cc8fbb2ab683,3PUV2Q8SV45ZEMG5DJR8KO6SNZ2DBM,0.04,0.0,Panel,7200,1089,5337,465,847,624,4490,0.06965,0
MTURK,6c418c234637a262f4b3cc8fbb2ab683,3OQQD2WO8I7BJ2SEQ4DDT2OTRCWI31,0.04,0.0,Panel,7200,1053,5156,445,795,608,4361,0.06864444444444445,0
MTURK,6c418c234637a262f4b3cc8fbb2ab683,3L21G7IH47X1ZZT47ILXRX3KJBCY1R,0.04,0.0,Panel,7200,1124,5367,497,888,627,4479,0.06981666666666667,0
MTURK,6c418c234637a262f4b3cc8fbb2ab683,37YYO3NWHDR8JZ2XRNSSB2USKKQCCS,0.04,0.0,Panel,7200,1150,5426,507,897,643,4529,0.07014444444444445,0
MTURK,6c418c234637a262f4b3cc8fbb2ab683,3W1K7D6QSBI2HNL151G5BGPVBHCZB7,0.04,0.0,Panel,7200,1167,5514,516,941,651,4573,0.07063333333333334,0
MTURK,6c418c234637a262f4b3cc8fbb2ab683,3BKZLF990Z0PG3DLSXBCSYBSRNAQYK,0.04,0.0,Panel,7200,1195,5575,557,860,638,4715,0.07097222222222223,0
MTURK,6c418c234637a262f4b3cc8fbb2ab683,3OWZNK3RYLQR7BRVGLOMTV7CFTLU2C,0.04,0.0,Panel,7200,1244,5726,589,887,655,4839,0.0718111111111111,0
MTURK,6c418c234637a262f4b3cc8fbb2ab683,3E22YV8GG17A4S8SLINCBDNBI7KPN2,0.04,0.0,Panel,7200,1172,5516,543,854,629,4662,0.07064444444444445,0
MTURK,6c418c234637a262f4b3cc8fbb2ab683,33NOQL7T9O0JFPNU2PWVKEZU3BSZ89,0.08,0.0,Panel,7200,1271,5850,606,894,665,4956,0.14500000000000002,0
MTURK,6c418c234637a262f4b3cc8fbb2ab683,3PA41K45VN5L17G55B6NFG1LISTP75,0.08,0.0,Panel,7200,1301,5880,619,899,682,4981,0.14533333333333334,0
MTURK,6c418c234637a262f4b3cc8fbb2ab683,3BFF0DJK8XD5CXT4AVDIFHYEU9DSTM,0.04,0.0,Panel,7200,1328,5939,638,932,690,5007,0.07299444444444445,0
MTURK,6c418c234637a262f4b3cc8fbb2ab683,373L46LKP71RBJWR6ULQFRJYXCOKJ8,0.07,0.0,Upside Services Inc,3600,305,2489,55,99,250,2390,0.11839722222222224,0
MTURK,6c418c234637a262f4b3cc8fbb2ab683,3VEI3XUCZRYVJQ0KEP4TKXSLJ4CRPV,0.04,0.0,Panel,7200,1037,3389,601,833,436,2556,0.058827777777777784,0
MTURK,6c418c234637a262f4b3cc8fbb2ab683,375VSR8FVWAPXU2Q1Y2VBVUZT3ERZB,0.08,2.0,Panel,7200,946,3089,562,798,384,2291,0.11432222222222223,0
MTURK,6c418c234637a262f4b3cc8fbb2ab683,3WRAAIUSBJ08TIGUY5SOJKPELZ1AXY,0.08,0.0,Panel,7200,946,3089,570,796,376,2293,0.11432222222222223,0
MTURK,6c418c234637a262f4b3cc8fbb2ab683,3CVBMEMMXBB7PYUHZ0TWZ9YXE0KH7U,0.07,0.0,Upside Services Inc,3600,152,690,106,237,46,453,0.08341666666666667,1
MTURK,6c418c234637a262f4b3cc8fbb2ab683,3NCN4N1H1GCM16JIFF0P9VHPJ2KBNJ,0.07,0.0,Upside Services Inc,3600,220,960,156,367,64,593,0.08866666666666667,1
MTURK,6c418c234637a262f4b3cc8fbb2ab683,3Y3CZJSZ9KURQGI1UAVFMRN4S4Q5R2,0.08,0.0,Panel,7200,943,3059,560,792,383,2267,0.11398888888888889,0
MTURK,6c418c234637a262f4b3cc8fbb2ab683,30UZJB2POHDZ7EXZJKUJ4TKOMQA53Y,0.04,0.0,Panel,7200,929,2909,536,759,393,2150,0.05616111111111111,0
MTURK,6c418c234637a262f4b3cc8fbb2ab683,3KI0JD2ZU1JDR1Y0QF7E9GA4NNO762,0.08,0.0,Panel,7200,858,2430,476,555,382,1875,0.107,0
MTURK,6c418c234637a262f4b3cc8fbb2ab683,3TUOHPJXYHY50VJXZAOG19M5DIRXWJ,0.04,0.0,Panel,7200,806,2160,438,413,368,1747,0.052000000000000005,0
MTURK,6c418c234637a262f4b3cc8fbb2ab683,3T5ZXGO9DEPPLTNQOJDV65KUXIOZQW,0.08,0.0,Panel,7200,779,2100,421,375,358,1725,0.10333333333333333,0
MTURK,6c418c234637a262f4b3cc8fbb2ab683,3L2OEKSTW9BJAZDP63UC67QSXIZ8Y4,0.08,0.0,Panel,7200,773,1979,414,322,359,1657,0.10198888888888889,0
MTURK,6c418c234637a262f4b3cc8fbb2ab683,359AP8GAGGL27I7106KHVG2EJ9W7CR,0.04,0.0,Panel,7200,796,1859,427,355,369,1504,0.05032777777777778,0
MTURK,6c418c234637a262f4b3cc8fbb2ab683,3O71U79SRBQ1Z23K1YC6T33M010MSY,0.08,6.0,Panel,7200,720,1739,375,328,345,1411,0.09932222222222223,0
MTURK,6c418c234637a262f4b3cc8fbb2ab683,3DIIW4IV8PWW1YBIQIIW37GZ5CZ4IF,0.04,0.0,Panel,7200,694,1260,374,301,320,959,0.047,0
MTURK,6c418c234637a262f4b3cc8fbb2ab683,3X0EMNLXEPQNCXH1N993LUHO4BXPVW,0.08,0.0,Panel,7200,597,1052,320,242,277,810,0.09168888888888889,0
MTURK,6c418c234637a262f4b3cc8fbb2ab683,3P7QK0GJ3TM8TAL5M8NUANMRHBGZ2M,0.08,0.0,Panel,7200,555,931,292,219,263,712,0.09034444444444445,0
MTURK,6c418c234637a262f4b3cc8fbb2ab683,3TZ0XG8CBUL49Y5HYR2W7QX1O8A899,0.08,0.0,Panel,7200,557,720,291,238,266,482,0.088,0
MTURK,6c418c234637a262f4b3cc8fbb2ab683,34O39PNDK69TFWZAVKMSPDNW215RBK,0.08,0.0,Panel,7200,519,660,265,164,254,496,0.08733333333333333,0
MTURK,6c418c234637a262f4b3cc8fbb2ab683,3SBX2M1TKDO9IWZ13QN5C97LWNN4QR,0.08,0.0,Panel,7200,396,390,195,103,201,287,0.08433333333333333,0
MTURK,6c418c234637a262f4b3cc8fbb2ab683,3MA5N0ATTCCZGVKQ0R9RBFE3HAUKW1,0.08,0.0,Panel,7200,271,239,131,93,140,146,0.08265555555555555,0
MTURK,6c418c234637a262f4b3cc8fbb2ab683,35F6NGNVM8KJTZ9CMSF7KQ2I7WAT7C,0.08,1.0,Panel,7200,298,240,152,129,146,111,0.08266666666666667,0
MTURK,6c418c234637a262f4b3cc8fbb2ab683,3VMV5CHJZ8G2MSKDFVJ1Q3FB6YYTGI,0.08,1.0,Panel,7200,298,240,152,129,146,111,0.08266666666666667,0
MTURK,6c418c234637a262f4b3cc8fbb2ab683,3PN6H8C9R4RUVCBD75RCPDMM5IUAD3,0.04,0.0,Panel,7200,297,209,151,130,146,79,0.041161111111111114,0
MTURK,6c418c234637a262f4b3cc8fbb2ab683,3J5XXLQDHMCG58CEPBCW8RENZF6V3R,0.06,5.0,Panel,7200,47,60,11,16,36,44,0.0605,0
MTURK,6c418c234637a262f4b3cc8fbb2ab683,3GVPRXWRPHVTKLT1SGG36J09WFVI7L,0.04,2.0,Panel,7200,39,38,16,5,23,33,0.040211111111111114,0
MTURK,6c418c234637a262f4b3cc8fbb2ab683,3UZUVSO3P7QEQRA2D5NFXOYAH9TME0,0.07,0.0,Upside Services Inc,3600,420,1801,65,253,355,1548,0.10501944444444444,1
MTURK,6c418c234637a262f4b3cc8fbb2ab683,3X55NP42EOH30OFI3Z3X2ZP5DRGP3B,0.04,0.0,Panel,7200,247,1049,88,163,159,886,0.04582777777777778,0
MTURK,6c418c234637a262f4b3cc8fbb2ab683,3SCKNODZ0XHLYM4SPWTVBRWQIE27N3,0.08,0.0,Panel,7200,213,808,81,131,132,677,0.08897777777777778,0
MTURK,6c418c234637a262f4b3cc8fbb2ab683,3MA5N0ATTCCZGVKQ0R9RBFE3HA5KWC,0.08,1.0,Panel,7200,237,838,90,137,147,701,0.08931111111111112,0
MTURK,6c418c234637a262f4b3cc8fbb2ab683,32XN26MTXZJNPJUQ4QGUTZHSQJO0L3,0.25,0.0,Housam Aburas,14400,1115,7860,258,608,857,7252,0.38645833333333335,0
MTURK,6c418c234637a262f4b3cc8fbb2ab683,3TTPFEFXCTLAKQ4C3OTQ0TZY1R96HU,0.04,0.0,Panel,7200,190,390,73,25,117,365,0.042166666666666665,0
MTURK,6c418c234637a262f4b3cc8fbb2ab683,3XQ4XW3OD9DBSYZRRGTMEUPOUXOS2K,0.08,0.0,Panel,7200,55,60,21,8,34,52,0.08066666666666666,0
MTURK,6c418c234637a262f4b3cc8fbb2ab683,3FDWKV9VCN3HEFVOQ37684LALZQUMT,0.08,0.0,Panel,7200,55,60,21,8,34,52,0.08066666666666666,0
MTURK,6c418c234637a262f4b3cc8fbb2ab683,3G5RUKN2ECY3DD4LHVMTIPMZV2ON9S,0.07,0.0,Upside Services Inc,3600,74,720,33,128,41,592,0.084,1
MTURK,6c418c234637a262f4b3cc8fbb2ab683,3SV8KD29L4T3AQPVBETYAJ8LYCAKZ3,0.04,0.0,Panel,7200,518,5040,71,240,447,4800,0.068,0
MTURK,6c418c234637a262f4b3cc8fbb2ab683,3Z56AA6EK41WC45NUL93SY7UID8M6J,0.08,0.0,Panel,7200,439,4560,39,122,400,4438,0.13066666666666668,0
MTURK,6c418c234637a262f4b3cc8fbb2ab683,38LRF35D5LXGSTNEKL2RC5C4L8AU3E,0.04,0.0,Panel,7200,645,5220,155,386,490,4834,0.069,0
MTURK,6c418c234637a262f4b3cc8fbb2ab683,3H781YYV6TJ42EOM90TDQ0UZTJSTEC,0.08,0.0,Panel,7200,629,3930,184,367,445,3563,0.12366666666666667,0
MTURK,6c418c234637a262f4b3cc8fbb2ab683,3D06DR5225KXZ6HQKYQF839GEWLMAW,0.08,0.0,Panel,7200,606,3512,194,309,412,3203,0.11902222222222222,0
MTURK,6c418c234637a262f4b3cc8fbb2ab683,33J5JKFMK6ZO00GX3CIM24FFIN2Q33,0.08,1.0,Panel,7200,295,1409,125,96,170,1313,0.09565555555555556,0
MTURK,6c418c234637a262f4b3cc8fbb2ab683,3R15W654VDOJHCIMMKH0RS8Z07UQLH,0.07,0.0,Upside Services Inc,3600,48,162,40,122,8,40,0.07315,1
MTURK,6c418c234637a262f4b3cc8fbb2ab683,3WUVMVA7OB4XYDG9ZNG9G55PT0GZA3,0.08,0.0,Panel,7200,41,60,27,30,14,30,0.08066666666666666,0
MTURK,6c418c234637a262f4b3cc8fbb2ab683,36JW4WBR06L63JXN4HWUUZCBUQCFH6,0.08,0.0,Panel,7200,16,23,5,2,11,21,0.08025555555555555,0
MTURK,6c418c234637a262f4b3cc8fbb2ab683,3L7SUC0TTUV1YTJ8SWTMJXX35CC0MQ,0.04,0.0,Panel,7200,990,2970,324,383,666,2587,0.0565,0
MTURK,6c418c234637a262f4b3cc8fbb2ab683,3P0I4CQYVY8I6M55YJ1KIWVC1GMOW9,0.06,0.0,Panel,7200,23,1104,15,1078,8,26,0.0692,1
MTURK,6c418c234637a262f4b3cc8fbb2ab683,363A7XIFV4NGPTBZYQR6VZST5R0VAT,0.04,0.0,Panel,7200,889,2100,305,135,584,1965,0.051666666666666666,0
MTURK,6c418c234637a262f4b3cc8fbb2ab683,3X55NP42EOH30OFI3Z3X2ZP5DSOP3L,0.04,0.0,Panel,7200,56,296,24,13,32,283,0.04164444444444444,1
MTURK,6c418c234637a262f4b3cc8fbb2ab683,3DGDV62G7OAEF6JZZZPSJPKD7EOP2A,0.04,0.0,Panel,7200,39,26,10,1,29,25,0.04014444444444445,0
MTURK,6c418c234637a262f4b3cc8fbb2ab683,3KLL7H3EGD2VZGJD4W1YCLFXIL6VHI,0.04,0.0,Panel,7200,73,62,30,2,43,60,0.04034444444444445,0
MTURK,6c418c234637a262f4b3cc8fbb2ab683,3I4E7AFQ2K0CDUAEN144NG7RYSTTJ4,0.04,0.0,Panel,7200,43,92,18,4,25,88,0.04051111111111111,1
MTURK,6c418c234637a262f4b3cc8fbb2ab683,391FPZIE4CNVM1UDZ6RTGZDE4D9HUP,0.08,0.0,Panel,7200,787,1709,269,146,518,1563,0.09898888888888889,0
MTURK,6c418c234637a262f4b3cc8fbb2ab683,3FBEFUUYRK6VA3WYXIJYJ7CUOYA6AE,0.06,1.0,Panel,7200,787,1709,269,146,518,1563,0.07424166666666666,0
MTURK,6c418c234637a262f4b3cc8fbb2ab683,32W3UF2EZOM5OVPIY8MAS4I4S91C4B,0.08,3.0,Panel,7200,815,1742,275,155,540,1587,0.09935555555555556,0
MTURK,6c418c234637a262f4b3cc8fbb2ab683,3G4VVJO6PZH9WMNPO5VWJL67OEFKPW,0.04,0.0,Panel,7200,810,1650,285,288,525,1362,0.049166666666666664,0
MTURK,6c418c234637a262f4b3cc8fbb2ab683,3DGDV62G7OAEF6JZZZPSJPKD7EI2PH,0.04,0.0,Panel,7200,89,212,35,30,54,182,0.04117777777777778,1
MTURK,6c418c234637a262f4b3cc8fbb2ab683,37ZQELHEQ0Z4JPBFT2VKU9TGD5INMJ,0.06,0.0,Panel,7200,762,1499,267,102,495,1397,0.07249166666666666,0
MTURK,6c418c234637a262f4b3cc8fbb2ab683,3L2OEKSTW9BJAZDP63UC67QSXJGY8D,0.04,0.0,Panel,7200,91,250,36,10,55,240,0.04138888888888889,0
MTURK,6c418c234637a262f4b3cc8fbb2ab683,3CIS7GGG65KJ2R3B95JNVWG1CY4UEB,0.04,0.0,Panel,7200,42,38,20,2,22,36,0.040211111111111114,0
MTURK,6c418c234637a262f4b3cc8fbb2ab683,31KSVEGZ34TL3ZXLQBIOCR0HC37RWM,0.04,0.0,Panel,7200,45,146,13,16,32,130,0.04081111111111111,0
MTURK,6c418c234637a262f4b3cc8fbb2ab683,39KV3A5D188IEZWXXSAHAL6W5EW7S3,0.08,0.0,Panel,7200,26,31,13,3,13,28,0.08034444444444444,0
MTURK,6c418c234637a262f4b3cc8fbb2ab683,3JMNNNO3B154ZFG0BL3NBJS90BOW29,0.08,0.0,Panel,7200,18,17,9,2,9,15,0.08018888888888889,0
MTURK,6c418c234637a262f4b3cc8fbb2ab683,35NNO802AVXIN6LO8NXS2GMZWW4NI9,0.04,0.0,Panel,7200,694,1203,249,92,445,1111,0.046683333333333334,0
MTURK,6c418c234637a262f4b3cc8fbb2ab683,3RZS0FBRWKBRDOB1WSEYV2TZJ51PCJ,0.04,1.0,Panel,7200,60,91,20,5,40,86,0.04050555555555556,0
MTURK,6c418c234637a262f4b3cc8fbb2ab683,3RKHNXPHGWXMORVL5RUQTRT6WV3KUO,0.04,1.0,Panel,7200,26,20,12,2,14,18,0.04011111111111111,0
MTURK,6c418c234637a262f4b3cc8fbb2ab683,3M7OI89LVYPJ3ITWHWFPP22IO0E6CX,0.04,0.0,Panel,7200,43,60,16,3,27,57,0.04033333333333333,0
MTURK,6c418c234637a262f4b3cc8fbb2ab683,3NKW03WTLM8LRYILDWTO71QCGH7QWM,0.04,1.0,Panel,7200,49,98,26,14,23,84,0.040544444444444445,1
MTURK,6c418c234637a262f4b3cc8fbb2ab683,3N7PQ0KLI5QZ3XQSULNM8NQ1ZLEE3H,0.08,0.0,Panel,7200,557,994,199,83,358,911,0.09104444444444444,0
MTURK,6c418c234637a262f4b3cc8fbb2ab683,3AC6MFV69KJC80ON5TQ1XRST6XWZH8,0.08,2.0,Panel,7200,564,984,202,79,362,905,0.09093333333333334,0
MTURK,6c418c234637a262f4b3cc8fbb2ab683,3NSCTNUR2ZOZRZWKSZ9TR1YUS2K5AG,0.04,0.0,Panel,7200,142,264,29,5,113,259,0.041466666666666666,0
MTURK,6c418c234637a262f4b3cc8fbb2ab683,37M4O367VJJ0T059P2ZY0STUMJ05MR,0.06,0.0,Panel,7200,480,780,200,77,280,703,0.0665,0
MTURK,6c418c234637a262f4b3cc8fbb2ab683,3G9UA71JVVUEX097NC9VY2EIHW0J7J,0.35,1.0,Shane P Singh,259200,8144,72295,2970,67827,5174,4468,0.44762056327160493,0
MTURK,6c418c234637a262f4b3cc8fbb2ab683,3HRWUH63QU36BIQ913EYD7IUR9R5N8,0.04,0.0,Panel,7200,62,89,23,3,39,86,0.040494444444444444,0
MTURK,6c418c234637a262f4b3cc8fbb2ab683,30EV7DWJTVWW6LU1DOXEMTU1RPA6YL,0.04,0.0,Panel,7200,69,201,27,4,42,197,0.04111666666666667,1
MTURK,6c418c234637a262f4b3cc8fbb2ab683,3PKVGQTFIHLPS4SL5C0CXOLXNCNYRA,0.04,0.0,Panel,7200,35,76,20,4,15,72,0.04042222222222222,1
MTURK,6c418c234637a262f4b3cc8fbb2ab683,3IZVJEBJ6ALWBB469AZX0033XJBZ62,0.04,0.0,Panel,7200,28,31,19,3,9,28,0.04017222222222222,0
MTURK,6c418c234637a262f4b3cc8fbb2ab683,301KG0KX9CMM2PLBGMHNAGIMLOT2HZ,0.08,0.0,Panel,7200,26,32,12,4,14,28,0.08035555555555556,0
MTURK,6c418c234637a262f4b3cc8fbb2ab683,39O6Z4JLX2YSL6JS90JKF73R6C6XVW,0.08,1.0,Panel,7200,25,40,14,6,11,34,0.08044444444444444,0
MTURK,6c418c234637a262f4b3cc8fbb2ab683,389A2A304OJOP77HF7Z8G1SRBY80C8,0.04,0.0,Panel,7200,24,55,15,4,9,51,0.04030555555555556,1
MTURK,6c418c234637a262f4b3cc8fbb2ab683,3VI0PC2ZAYLXVMAV8OX6KF9JAJBXOW,0.08,0.0,Panel,7200,43,31,22,3,21,28,0.08034444444444444,0
MTURK,6c418c234637a262f4b3cc8fbb2ab683,37AQKJ12TXP6RX6JZVI8PMU0WV5TTW,0.06,0.0,Panel,7200,238,360,91,62,147,298,0.063,0
MTURK,6c418c234637a262f4b3cc8fbb2ab683,3IYI9285WS1VRD831F9EY67NA7GCJT,0.04,0.0,Panel,7200,55,180,24,54,31,126,0.041,1
MTURK,6c418c234637a262f4b3cc8fbb2ab683,3OND0WXMHWGEX5XR96COCHRBIRPHEM,0.04,0.0,Panel,7200,44,90,23,30,21,60,0.0405,0
MTURK,6c418c234637a262f4b3cc8fbb2ab683,3Q2T3FD0ON9XFLI5BJB5LVVA8NPM3Y,0.04,0.0,Panel,7200,34,59,20,13,14,46,0.04032777777777778,0
MTURK,6c418c234637a262f4b3cc8fbb2ab683,3VGET1QSZ00BLGD6HXKI7A9HBSY7WQ,0.04,0.0,Panel,7200,94,301,42,48,52,253,0.04167222222222222,1
MTURK,6c418c234637a262f4b3cc8fbb2ab683,3O2Y2UIUCQVX59YVA2ZR7RS3M98FK6,0.04,0.0,Panel,7200,46,150,19,8,27,142,0.04083333333333333,1
MTURK,6c418c234637a262f4b3cc8fbb2ab683,3BS6ERDL938T8AZAHSA098K090JD6X,0.06,0.0,Panel,7200,75,241,34,94,41,147,0.06200833333333333,1
MTURK,6c418c234637a262f4b3cc8fbb2ab683,3QREJ3J433YJ518RWD2P24XNJ5UKLG,0.06,1.0,Panel,7200,65,240,37,90,28,150,0.062,1
MTURK,6c418c234637a262f4b3cc8fbb2ab683,3K1H3NEY7L0V53OGT5JMLZXP3FBDGQ,0.08,1.0,Panel,7200,83,270,48,92,35,178,0.083,1
MTURK,6c418c234637a262f4b3cc8fbb2ab683,3NFWQRSHVEFS3N2CKBEC9Z0AFSRGF4,0.04,0.0,Panel,7200,78,272,40,22,38,250,0.04151111111111111,0
MTURK,6c418c234637a262f4b3cc8fbb2ab683,338GLSUI43CVTSB3FB8TYDJD33LSF0,0.04,0.0,Panel,7200,51,178,29,19,22,159,0.04098888888888889,1
MTURK,6c418c234637a262f4b3cc8fbb2ab683,3WYZV0QBFJEDCSLM4JSKEV9K3J8XB6,0.08,4.0,Panel,7200,87,243,46,83,41,160,0.0827,0
MTURK,6c418c234637a262f4b3cc8fbb2ab683,3LCXHSGDLTSO7QMLV9O3JUFZWPTSE1,1.0,0.0,Yoonjong Lee,900,206,660,65,107,141,553,1.7333333333333334,1
MTURK,6c418c234637a262f4b3cc8fbb2ab683,3UEDKCTP9VRKQGJPSJ1FJZFMOKKK70,0.08,0.0,Panel,7200,283,901,87,154,196,747,0.09001111111111111,0
MTURK,6c418c234637a262f4b3cc8fbb2ab683,3XBYQ44Z6P5YJEADU0NJC61Z0NXTWS,0.08,0.0,Panel,7200,250,871,79,109,171,762,0.08967777777777777,0
MTURK,6c418c234637a262f4b3cc8fbb2ab683,37SOB9Z0SSYD930KB7AQLIGL8JIL3G,0.04,0.0,Panel,7200,248,753,95,143,153,610,0.04418333333333333,0
MTURK,6c418c234637a262f4b3cc8fbb2ab683,3IVKZBIBJ0AF7O29A1WT1YVQJGOHS9,0.08,0.0,Panel,7200,170,421,72,72,98,349,0.08467777777777778,0
MTURK,6c418c234637a262f4b3cc8fbb2ab683,3UAU495MIIT5EIG03JMJ08AFG0MUOR,0.08,0.0,Panel,7200,100,180,49,47,51,133,0.082,0
MTURK,6c418c234637a262f4b3cc8fbb2ab683,3VQTAXTYN3MLVORRZEHXUOAG92OBUR,0.04,0.0,Panel,7200,307,2489,34,80,273,2409,0.05382777777777778,1
MTURK,6c418c234637a262f4b3cc8fbb2ab683,32CAVSKPCEQKIQ9ZXHO8OCX7NQPU1J,0.08,1.0,Panel,7200,360,2503,62,126,298,2377,0.10781111111111111,0
MTURK,6c418c234637a262f4b3cc8fbb2ab683,3MA5N0ATTCCZGVKQ0R9RBFE3HC8WKV,0.04,0.0,Panel,7200,324,1928,71,125,253,1803,0.05071111111111111,0
MTURK,6c418c234637a262f4b3cc8fbb2ab683,3HEM8MA6H9DV7PLK1AFTF7IGNK2QPP,0.08,2.0,Panel,7200,361,1926,85,99,276,1827,0.1014,0
MTURK,6c418c234637a262f4b3cc8fbb2ab683,3X878VYTIEJ9AURBR8AI3MNHGP27FM,0.08,0.0,Panel,7200,402,1954,101,103,301,1851,0.10171111111111111,0
MTURK,6c418c234637a262f4b3cc8fbb2ab683,3UDTAB6HH60MR90E3NPHEBRJ5C690Z,0.08,1.0,Panel,7200,425,1421,119,98,306,1323,0.0957888888888889,0
MTURK,6c418c234637a262f4b3cc8fbb2ab683,32CXT5U14G42TQTKW2XN3MKF1W28UO,0.04,0.0,Panel,7200,439,1291,130,99,309,1192,0.047172222222222226,0
MTURK,6c418c234637a262f4b3cc8fbb2ab683,3NSCTNUR2ZOZRZWKSZ9TR1YUS2B5A7,0.08,0.0,Panel,7200,355,869,109,67,246,802,0.08965555555555556,0
MTURK,6c418c234637a262f4b3cc8fbb2ab683,32LAQ1JNT9QLRAL8Z08IUIG2F8BTUK,0.08,0.0,Panel,7200,737,5971,230,553,507,5418,0.14634444444444444,0
MTURK,6c418c234637a262f4b3cc8fbb2ab683,3A9LA2FRXW0VXTP11CCD3I5HI7PHXC,1.0,0.0,Alexander Green,3600,202,2100,107,440,95,1660,1.5833333333333335,0
MTURK,6c418c234637a262f4b3cc8fbb2ab683,3FTID4TN8LZEP6X80S3GBCCYHK5YLR,0.08,0.0,Panel,7200,451,5553,139,513,312,5040,0.1417,0
MTURK,6c418c234637a262f4b3cc8fbb2ab683,3MD8CKRQZZOZXFXMJCZ9N169A8CJRZ,0.08,0.0,Panel,7200,396,4233,120,1150,276,3083,0.12703333333333333,0
MTURK,6c418c234637a262f4b3cc8fbb2ab683,3OCZWXS7ZO8GNINOPQYJ0FE5MEHL5C,0.08,0.0,Panel,7200,338,3453,78,104,260,3349,0.11836666666666668,0
MTURK,6c418c234637a262f4b3cc8fbb2ab683,37OPIVELUU4B7SGFT1A2GY1KXBHAH8,0.08,0.0,Panel,7200,329,3274,78,104,251,3170,0.11637777777777777,0
MTURK,6c418c234637a262f4b3cc8fbb2ab683,31MBOZ6PAOS1M3W340LRELKFEWXCL7,0.04,0.0,Panel,7200,283,2374,78,59,205,2315,0.05318888888888889,0
MTURK,6c418c234637a262f4b3cc8fbb2ab683,306996CF6WL5MR0TXQ7DJM5JY5RB1S,0.08,0.0,Panel,7200,305,1803,103,66,202,1737,0.10003333333333334,0
MTURK,6c418c234637a262f4b3cc8fbb2ab683,3N7PQ0KLI5QZ3XQSULNM8NQ1ZMK3EE,0.04,0.0,Panel,7200,229,360,103,54,126,306,0.042,0
MTURK,6c418c234637a262f4b3cc8fbb2ab683,3PCPFX4U40RJGCWQN7JO3D4CLFDFQB,0.04,0.0,Panel,7200,326,1560,126,154,200,1406,0.048666666666666664,0
MTURK,6c418c234637a262f4b3cc8fbb2ab683,37MQ8Z1JQEX8OKB0QMLBWGDPBKOY2C,0.04,0.0,Panel,7200,415,2609,158,488,257,2121,0.05449444444444444,0
MTURK,6c418c234637a262f4b3cc8fbb2ab683,32XN26MTXZJR8BKBKE78IR20WU30L2,1.38,0.0,Jess Hohenstein,2100,170,1291,46,193,124,1098,2.2283714285714282,1
MTURK,6c418c234637a262f4b3cc8fbb2ab683,3MG8450X2OBNZIS1IJZYP8F5Q66PUT,0.04,0.0,Panel,7200,239,1889,91,1081,148,808,0.050494444444444446,0
MTURK,6c418c234637a262f4b3cc8fbb2ab683,367O8HRHKG9LVCEEVUCA79MMEDQ4S2,0.04,0.0,Panel,7200,265,2009,104,1094,161,915,0.051161111111111116,0
MTURK,6c418c234637a262f4b3cc8fbb2ab683,38O9DZ0A62O6501UK3QJDPTWCAX26I,0.04,0.0,Panel,7200,297,2190,121,1110,176,1080,0.05216666666666667,0
MTURK,6c418c234637a262f4b3cc8fbb2ab683,3M67TQBQQHPISMYWVPMA3H3WEYK9AS,0.08,0.0,Panel,7200,138,450,25,22,113,428,0.085,0
MTURK,6c418c234637a262f4b3cc8fbb2ab683,3CESM1J3EI4SHGZ1YNFQ1W9LGI86WM,0.04,7.0,Panel,7200,303,2551,154,733,149,1818,0.054172222222222226,1
MTURK,6c418c234637a262f4b3cc8fbb2ab683,32CAVSKPCEQKIQ9ZXHO8OCX7NRH1UK,0.04,8.0,Panel,7200,322,2580,166,740,156,1840,0.05433333333333333,1
MTURK,6c418c234637a262f4b3cc8fbb2ab683,371DNNCG58QQNDR71FQ2YSUSIZAT8O,0.3,0.0,Marcel Beermann,600,67,389,39,331,28,58,0.4945,1
MTURK,6c418c234637a262f4b3cc8fbb2ab683,3BPP3MA3TCLGJ1GH0RRM49KIZ9SELM,0.08,0.0,Panel,7200,1160,5909,749,2621,411,3288,0.14565555555555557,0
MTURK,6c418c234637a262f4b3cc8fbb2ab683,37NXA7GVST7XLC23VHGW4D84Z4VVL9,0.04,7.0,Panel,7200,330,2519,178,710,152,1809,0.05399444444444444,1
MTURK,6c418c234637a262f4b3cc8fbb2ab683,3RTFSSG7T87A0128LRLSQFRI6DXWLK,0.04,6.0,Panel,7200,342,2520,193,711,149,1809,0.054,1
MTURK,6c418c234637a262f4b3cc8fbb2ab683,3WYZV0QBFJEDCSLM4JSKEV9K3LPXBR,0.04,3.0,Panel,7200,338,2490,191,673,147,1817,0.05383333333333334,1
MTURK,6c418c234637a262f4b3cc8fbb2ab683,3E9ZFLPWOYTNZ0ZSATK10IDXYB9XI0,0.08,4.0,Panel,7200,1224,5940,797,2607,427,3333,0.14600000000000002,0
MTURK,6c418c234637a262f4b3cc8fbb2ab683,3L1EFR8WWT6DODF46582HIENBGR9F3,0.08,4.0,Panel,7200,1224,5940,797,2607,427,3333,0.14600000000000002,0
MTURK,6c418c234637a262f4b3cc8fbb2ab683,3VDI8GSXAFUJO8SPCX86Z7JOSP98GC,0.04,11.0,Panel,7200,361,2460,204,617,157,1843,0.05366666666666667,0
MTURK,6c418c234637a262f4b3cc8fbb2ab683,306W7JMRYYZNXRKEWBGSYWSRCCHB8Y,0.08,6.0,Panel,7200,1302,6210,838,2619,464,3591,0.14900000000000002,0
MTURK,6c418c234637a262f4b3cc8fbb2ab683,3HO4MYYR12PFPCAW3N0PJ8OOV2ZU6D,0.04,8.0,Panel,7200,364,2430,191,438,173,1992,0.0535,0
MTURK,6c418c234637a262f4b3cc8fbb2ab683,3RBI0I35XE4X927JUMZGFQIHHZ93YF,0.04,0.0,Panel,7200,464,2790,259,664,205,2126,0.0555,0
MTURK,6c418c234637a262f4b3cc8fbb2ab683,3SU800BH86T8ZUTGIWENPD5FV3BQU6,0.04,0.0,Panel,7200,497,2940,283,793,214,2147,0.05633333333333333,0
MTURK,6c418c234637a262f4b3cc8fbb2ab683,3T2EL38U0ML0GYNBN1PA9K4JPLTQXZ,0.08,1.0,Panel,7200,1271,5969,812,2390,459,3579,0.14632222222222224,0
MTURK,6c418c234637a262f4b3cc8fbb2ab683,3X878VYTIEJ9AURBR8AI3MNHGQ57FR,0.04,0.0,Panel,7200,653,3720,406,1479,247,2241,0.06066666666666667,0
MTURK,6c418c234637a262f4b3cc8fbb2ab683,379OL9DBSSFJO4WZBV0Q63L3HRJY9R,0.08,0.0,Panel,7200,1379,6180,882,2407,497,3773,0.14866666666666667,0
MTURK,6c418c234637a262f4b3cc8fbb2ab683,32PT7WK7DMGUBRCSYQC2258GZB43D8,0.04,0.0,Panel,7200,546,3120,328,978,218,2142,0.05733333333333333,0
MTURK,6c418c234637a262f4b3cc8fbb2ab683,3R5OYNIC2CA8Z5DCIE9OKCT37TJPTO,0.04,0.0,Panel,7200,609,3450,377,1260,232,2190,0.05916666666666667,0
MTURK,6c418c234637a262f4b3cc8fbb2ab683,3V7ICJJAZAHMEQXCK8QFHKCMAQOB4U,0.04,1.0,Panel,7200,782,4170,512,1788,270,2382,0.06316666666666668,0
MTURK,6c418c234637a262f4b3cc8fbb2ab683,35JDMRECC4A0X92GP0U6RHFA3SAEGK,0.04,1.0,Panel,7200,828,4380,545,1900,283,2480,0.06433333333333334,0
MTURK,6c418c234637a262f4b3cc8fbb2ab683,3B9XR6P1WEWCH8GXNFDJNM15SNEBJL,0.08,14.0,Panel,7200,1394,6180,894,2415,500,3765,0.14866666666666667,0
MTURK,6c418c234637a262f4b3cc8fbb2ab683,3UUSLRKAUL4CCADF02FSFMKW4DR7DI,0.08,0.0,Panel,7200,1503,6630,957,2553,546,4077,0.15366666666666667,0
MTURK,6c418c234637a262f4b3cc8fbb2ab683,34XASH8KLQHINIZSMJ3QR0XEVGEMP4,0.07,551.0,Upside Services Inc,3600,133,1650,62,217,71,1433,0.10208333333333333,1
MTURK,6c418c234637a262f4b3cc8fbb2ab683,3UY4PIS8QRM7N0PQ0GCMAH5DFVTN1J,0.08,0.0,Panel,7200,1604,6780,1029,2718,575,4062,0.15533333333333332,0
MTURK,6c418c234637a262f4b3cc8fbb2ab683,3W1K7D6QSBCGIVX1I3BJ4IOYTHOBZY,0.07,2531.0,Upside Services Inc,3600,211,600,132,142,79,458,0.08166666666666668,0
MTURK,6c418c234637a262f4b3cc8fbb2ab683,38O9DZ0A62IK68DUX5LX6RSZU7E26W,0.07,0.0,Upside Services Inc,3600,221,569,138,229,83,340,0.0810638888888889,0
MTURK,6c418c234637a262f4b3cc8fbb2ab683,3CZH926SIC9YM1LW71NJBUHAVJYE4P,0.07,2781.0,Upside Services Inc,3600,261,840,160,402,101,438,0.08633333333333335,0
MTURK,6c418c234637a262f4b3cc8fbb2ab683,3UAU495MIIT5EIG03JMJ08AFG22UOB,0.04,0.0,Panel,7200,1074,4079,708,2073,366,2006,0.06266111111111111,0
MTURK,6c418c234637a262f4b3cc8fbb2ab683,33QQ60S6ASDYC90HE0FM39D00VBU05,0.07,95.0,Upside Services Inc,3600,266,1080,179,668,87,412,0.09100000000000001,0
MTURK,6c418c234637a262f4b3cc8fbb2ab683,3UAU495MIINJFQS0GLHXTA9IYYQUOU,0.07,2165.0,Upside Services Inc,3600,304,1380,216,971,88,409,0.09683333333333334,0
MTURK,6c418c234637a262f4b3cc8fbb2ab683,32K26U12DNJSO8QBV2DME2Z28RSDV5,0.07,1741.0,Upside Services Inc,3600,364,1619,264,1171,100,448,0.10148055555555557,0
MTURK,6c418c234637a262f4b3cc8fbb2ab683,3KQC8JMJGCNPOFTUXOQ6MSMH9ZXH3Q,0.07,0.0,Upside Services Inc,3600,361,1679,279,1379,82,300,0.10264722222222222,0
MTURK,6c418c234637a262f4b3cc8fbb2ab683,3MA5N0ATTC6DH3WQDT454HD6Z9UKW2,0.07,0.0,Upside Services Inc,3600,371,1649,281,1348,90,301,0.1020638888888889,0
MTURK,6c418c234637a262f4b3cc8fbb2ab683,38B7Q9C28G0V6SYTIE0CGE0D0DP96W,0.07,6018.0,Upside Services Inc,3600,395,1800,300,1361,95,439,0.10500000000000001,0
MTURK,6c418c234637a262f4b3cc8fbb2ab683,37VUR2VJ6AK2X44ZOSYMN8A4YNF1CA,0.07,0.0,Upside Services Inc,3600,413,1921,316,1399,97,522,0.10735277777777778,0
MTURK,6c418c234637a262f4b3cc8fbb2ab683,3B9J25CZ2582RO3T1BD6J9XDONPCS2,0.07,4480.0,Upside Services Inc,3600,491,2159,367,1413,124,746,0.11198055555555556,0
MTURK,6c418c234637a262f4b3cc8fbb2ab683,36GJS3V78VLM9X08G30BHZR5QW9JG8,0.07,0.0,Upside Services Inc,3600,545,2400,395,1458,150,942,0.11666666666666667,0
MTURK,6c418c234637a262f4b3cc8fbb2ab683,3FCO4VKOZ48V5O3F9ZLQE61KMLW7EA,0.07,0.0,Upside Services Inc,3600,616,2369,424,1251,192,1118,0.1160638888888889,0
MTURK,6c418c234637a262f4b3cc8fbb2ab683,3P7RGTLO6E8GAQTNCO8DMSGF7QSAKI,0.07,1747.0,Upside Services Inc,3600,690,2639,461,1284,229,1355,0.12131388888888889,0
MTURK,6c418c234637a262f4b3cc8fbb2ab683,3NI0WFPPI9BDAYAGIIHJN3ZKX9X06D,0.07,1202.0,Upside Services Inc,3600,729,2519,474,1006,255,1513,0.11898055555555556,0
MTURK,6c418c234637a262f4b3cc8fbb2ab683,324N5FAHSX602EWLNJZ9IFUSS0YVK9,0.07,0.0,Upside Services Inc,3600,729,2519,474,1006,255,1513,0.11898055555555556,0
MTURK,6c418c234637a262f4b3cc8fbb2ab683,3B286OTISECLZ6N5U381LDG2S1TAJK,0.07,0.0,Upside Services Inc,3600,829,2999,523,1099,306,1900,0.1283138888888889,0
MTURK,6c418c234637a262f4b3cc8fbb2ab683,38Z7YZ2SB3XHRBAG1HKNZCG7J4UIQR,0.07,0.0,Upside Services Inc,3600,971,3299,620,1296,351,2003,0.13414722222222225,0
MTURK,6c418c234637a262f4b3cc8fbb2ab683,3XBYQ44Z6PZCKMMD72IX5802IMRWTQ,0.07,0.0,Upside Services Inc,3600,925,3090,585,1136,340,1954,0.13008333333333333,0
MTURK,6c418c234637a262f4b3cc8fbb2ab683,3GVPRXWRPHP7LT515IBHZLZCEE5I7W,0.07,0.0,Upside Services Inc,3600,958,3000,606,1122,352,1878,0.12833333333333335,0
MTURK,6c418c234637a262f4b3cc8fbb2ab683,38LRF35D5LRUT1ZEXNX557B73713UF,0.07,2.0,Upside Services Inc,3600,931,2731,592,989,339,1742,0.12310277777777778,0
MTURK,6c418c234637a262f4b3cc8fbb2ab683,302U8RURJZW1AKHOKWRPA7BWMV4NV7,0.07,2.0,Upside Services Inc,3600,877,2521,554,910,323,1611,0.11901944444444446,0
MTURK,6c418c234637a262f4b3cc8fbb2ab683,3A9LA2FRWS914D08HDXUT8BLGU7HXZ,0.07,2.0,Upside Services Inc,3600,605,1621,392,703,213,918,0.10151944444444445,0
MTURK,6c418c234637a262f4b3cc8fbb2ab683,3MJ28H2Y1E32UB2LFK9PLYH2ZHD5O3,0.07,0.0,Upside Services Inc,3600,628,1470,406,657,222,813,0.09858333333333334,0
MTURK,6c418c234637a262f4b3cc8fbb2ab683,3YZ7A3YHR5OHS3UEM1QY53R3W6GS5N,0.07,0.0,Upside Services Inc,3600,663,1650,437,795,226,855,0.10208333333333333,0
MTURK,6c418c234637a262f4b3cc8fbb2ab683,3YZ7A3YHR5U3RVIE9ZVKC1S0EA9S5L,0.08,2.0,Panel,7200,597,1409,396,735,201,674,0.09565555555555556,0
MTURK,6c418c234637a262f4b3cc8fbb2ab683,3SX4X51T80ALZ922XE5S07YL9ZGAOL,0.08,1.0,Panel,7200,740,4203,401,806,339,3397,0.1267,0
MTURK,6c418c234637a262f4b3cc8fbb2ab683,3NQUW096N69ZO5P0SGB0CVJ78CI9LD,0.08,1.0,Panel,7200,662,3903,351,648,311,3255,0.12336666666666668,0
MTURK,6c418c234637a262f4b3cc8fbb2ab683,389A2A304OJOP77HF7Z8G1SRBZ6C0K,0.08,0.0,Panel,7200,668,3946,351,639,317,3307,0.12384444444444445,0
MTURK,6c418c234637a262f4b3cc8fbb2ab683,38Z7YZ2SB333Q3YGOFP96AH4184QIE,0.08,1.0,Panel,7200,661,3931,342,644,319,3287,0.12367777777777778,0
MTURK,6c418c234637a262f4b3cc8fbb2ab683,3LB1BGHFL2X28J5D9157X3MFBY1YT6,0.08,0.0,Panel,7200,695,4231,338,644,357,3587,0.12701111111111113,0
MTURK,6c418c234637a262f4b3cc8fbb2ab683,3H5TOKO3D9KG8EGHOH9764QUWPH648,0.08,0.0,Panel,7200,737,4260,362,650,375,3610,0.12733333333333335,0
MTURK,6c418c234637a262f4b3cc8fbb2ab683,338GLSUI43CVTSB3FB8TYDJD34QFSU,0.08,0.0,Panel,7200,694,4050,332,516,362,3534,0.125,0
MTURK,6c418c234637a262f4b3cc8fbb2ab683,3SCKNODZ0XHLYM4SPWTVBRWQIHXN7K,0.08,0.0,Panel,7200,716,4050,346,499,370,3551,0.125,0
MTURK,6c418c234637a262f4b3cc8fbb2ab683,3AQN9REUTFHVRU9GNB5SSZ4T8CEDY3,0.08,0.0,Panel,7200,655,4050,302,484,353,3566,0.125,0
MTURK,6c418c234637a262f4b3cc8fbb2ab683,3WRKFXQBOB8CZ5P2FP63JWK60HAIYY,0.08,0.0,Panel,7200,699,4080,324,486,375,3594,0.12533333333333335,0
MTURK,6c418c234637a262f4b3cc8fbb2ab683,3MG8450X2OBNZIS1IJZYP8F5Q76UP0,0.08,0.0,Panel,7200,699,4020,324,459,375,3561,0.12466666666666668,0
MTURK,6c418c234637a262f4b3cc8fbb2ab683,35XW21VSVGFHTKLZ1MBRTQOX00LLSE,0.08,0.0,Panel,7200,657,3990,285,375,372,3615,0.12433333333333334,0
MTURK,6c418c234637a262f4b3cc8fbb2ab683,36QZ6V1589EKCA8TA03SKDKGDR5SU6,0.08,3.0,Panel,7200,645,4028,244,356,401,3672,0.12475555555555556,0
MTURK,6c418c234637a262f4b3cc8fbb2ab683,32CAVSKPCEQKIQ9ZXHO8OCX7NR31U6,0.08,0.0,Panel,7200,704,4080,267,351,437,3729,0.12533333333333335,0
MTURK,6c418c234637a262f4b3cc8fbb2ab683,36BTXXLZ2V99UXE1G5C5HZHQSCO4RX,0.08,0.0,Panel,7200,641,3990,226,289,415,3701,0.12433333333333334,0
MTURK,6c418c234637a262f4b3cc8fbb2ab683,3J5XXLQDHMCG58CEPBCW8RENZI6V3X,0.08,0.0,Panel,7200,682,3480,238,868,444,2612,0.11866666666666667,0
MTURK,6c418c234637a262f4b3cc8fbb2ab683,3B9J25CZ25EOQGRTO9ISQ7YA6RFSCD,0.04,0.0,Panel,7200,573,1289,242,3060,331,-1771,0.04716111111111111,0
MTURK,6c418c234637a262f4b3cc8fbb2ab683,3X4Q1O9UBHN3G744QBT8QGWV8RX7OE,0.08,2.0,Panel,7200,537,1257,223,354,314,903,0.09396666666666667,0
MTURK,6c418c234637a262f4b3cc8fbb2ab683,31J7RYECZLRHZ0M5O3W7XP1OA0O1LQ,0.08,2.0,Panel,7200,505,1141,210,466,295,675,0.09267777777777778,0
MTURK,6c418c234637a262f4b3cc8fbb2ab683,31ANT7FQN83E1M4YY5JL8NLY5ZX5HI,0.08,0.0,Panel,7200,477,899,211,692,266,207,0.0899888888888889,0
MTURK,6c418c234637a262f4b3cc8fbb2ab683,30ZKOOGW2W703HV1RC7HOBLDGOR1AA,0.08,1.0,Panel,7200,423,660,191,195,232,465,0.08733333333333333,0
MTURK,6c418c234637a262f4b3cc8fbb2ab683,3FBEFUUYRK6VA3WYXIJYJ7CUOZH6AN,0.08,1.0,Panel,7200,400,630,176,187,224,443,0.08700000000000001,0
MTURK,6c418c234637a262f4b3cc8fbb2ab683,3M0556243SLYDFJY7FR7ZJ97G5AFNA,0.08,1.0,Panel,7200,434,1283,184,224,250,1059,0.09425555555555556,0
MTURK,6c418c234637a262f4b3cc8fbb2ab683,3DZKABX2ZI64I88XI4NX1UIH5VOCVH,0.08,0.0,Panel,7200,444,1290,181,195,263,1095,0.09433333333333334,0
MTURK,6c418c234637a262f4b3cc8fbb2ab683,3DZKABX2ZI64I88XI4NX1UIH5TOVCW,0.08,0.0,Panel,7200,386,1168,168,186,218,982,0.09297777777777778,0
MTURK,6c418c234637a262f4b3cc8fbb2ab683,39HYCOOPKOMVXDK248HHY4HMZ01DMA,0.08,0.0,Panel,7200,391,1145,168,211,223,934,0.09272222222222222,0
MTURK,6c418c234637a262f4b3cc8fbb2ab683,3MYASTQBG7CMISIUW1OYFD1R93GDQJ,0.08,0.0,Panel,7200,281,1011,105,150,176,861,0.09123333333333333,0
MTURK,6c418c234637a262f4b3cc8fbb2ab683,3QXFBUZ4ZKHHM5Z2F09BVZ1DPG9UGM,0.08,0.0,Panel,7200,276,954,99,214,177,740,0.0906,0
MTURK,6c418c234637a262f4b3cc8fbb2ab683,3VI0PC2ZAYLXVMAV8OX6KF9JAKJXO6,0.08,0.0,Panel,7200,273,420,113,215,160,205,0.08466666666666667,0
MTURK,6c418c234637a262f4b3cc8fbb2ab683,3W0XM68YZPW6FU4N33K6IPO9L0VK1I,0.08,0.0,Panel,7200,60,34436,18,34385,42,51,0.46262222222222227,0
MTURK,6c418c234637a262f4b3cc8fbb2ab683,3XH7ZM9YX2VAR3KDX08WY7S6E4C9R8,0.08,0.0,Panel,7200,371,4700,33,92,338,4608,0.13222222222222224,0
MTURK,6c418c234637a262f4b3cc8fbb2ab683,36FQTHX3Z3S1WUE8KULW7FKGWQOB35,0.08,0.0,Panel,7200,335,3985,33,46,302,3939,0.12427777777777778,0
MTURK,6c418c234637a262f4b3cc8fbb2ab683,3BFF0DJK8XD5CXT4AVDIFHYEUEUTSE,0.08,0.0,Panel,7200,213,2220,43,42,170,2178,0.10466666666666667,0
MTURK,6c418c234637a262f4b3cc8fbb2ab683,3566S7OX5DKIKFX3K9VXEKJNFHR17R,0.08,0.0,Panel,7200,238,2341,48,41,190,2300,0.10601111111111111,0
MTURK,6c418c234637a262f4b3cc8fbb2ab683,336OE47KI2LDW6E2ZVNYDOPKXC7WVD,0.08,0.0,Panel,7200,294,3177,75,177,219,3000,0.11530000000000001,1
MTURK,6c418c234637a262f4b3cc8fbb2ab683,3X2YVV51PUCMXC577HMNDUR4MY8W15,0.5,1.0,yong Jae Ko,3600,166,1030,57,160,109,870,0.6430555555555555,1
MTURK,6c418c234637a262f4b3cc8fbb2ab683,3G57RS03HJEIOGA8FJTA6TNO6M552J,0.3,0.0,Yuval Kirstain,3600,28,60,13,16,15,44,0.305,0
MTURK,6c418c234637a262f4b3cc8fbb2ab683,3SR6AEG6W5UC3AEI97OIJKJR05BHYM,0.04,0.0,Panel,7200,508,2551,226,624,282,1927,0.054172222222222226,0
MTURK,6c418c234637a262f4b3cc8fbb2ab683,35U0MRQMUJ85RX5089WOWUCYUANOV8,0.04,0.0,Panel,7200,616,2912,247,625,369,2287,0.05617777777777778,0
MTURK,6c418c234637a262f4b3cc8fbb2ab683,3MQY1YVHS3LCBCIPGU7RO5FOQDC2BB,0.08,27.0,Panel,7200,102,300,37,93,65,207,0.08333333333333333,0
MTURK,6c418c234637a262f4b3cc8fbb2ab683,3B0MCRZMBRVA7DK51X04F2S6IRIPP5,0.08,0.0,Panel,7200,653,2911,268,604,385,2307,0.11234444444444444,0
MTURK,6c418c234637a262f4b3cc8fbb2ab683,3UAU495MIINJFQS0GLHXTA9IYYPOUN,0.07,0.0,Upside Services Inc,3600,281,1680,110,388,171,1292,0.10266666666666668,0
MTURK,6c418c234637a262f4b3cc8fbb2ab683,3L55D8AUFASZNAF20H5V1VLE58HCYC,0.07,0.0,Upside Services Inc,3600,330,1890,140,442,190,1448,0.10675000000000001,0
MTURK,6c418c234637a262f4b3cc8fbb2ab683,3JMQI2OLFZ61FV52G9WHBJ6M4TGDNL,0.08,0.0,Panel,7200,617,2729,255,560,362,2169,0.11032222222222222,0
MTURK,6c418c234637a262f4b3cc8fbb2ab683,3NCN4N1H1GI80Y7I2D5BGTIM183BNB,0.04,0.0,Panel,7200,662,2763,266,559,396,2204,0.05535,0
MTURK,6c418c234637a262f4b3cc8fbb2ab683,3GVPRXWRPHVTKLT1SGG36J09WJJ7I6,0.04,0.0,Panel,7200,727,2940,291,582,436,2358,0.05633333333333333,0
MTURK,6c418c234637a262f4b3cc8fbb2ab683,3EQVJH0T40MGMOFOZ11JB3RCL3VHTZ,0.04,0.0,Panel,7200,727,2940,291,582,436,2358,0.05633333333333333,0
MTURK,6c418c234637a262f4b3cc8fbb2ab683,3DZKABX2ZI64I88XI4NX1UIH5W6CV1,0.04,0.0,Panel,7200,782,3213,303,569,479,2644,0.05785,0
MTURK,6c418c234637a262f4b3cc8fbb2ab683,33CLA8O0MICJSDBQ0M8O83EHH3LRFY,0.04,0.0,Panel,7200,871,3420,339,585,532,2835,0.059,0
MTURK,6c418c234637a262f4b3cc8fbb2ab683,32XN26MTXZKHSB1NSKS7JKIE597L0Y,0.08,2.0,Panel,7200,883,3450,343,585,540,2865,0.11833333333333335,0
MTURK,6c418c234637a262f4b3cc8fbb2ab683,3FO95NVK5C1SWIGC668NF2XW6TFRSH,0.04,0.0,Panel,7200,946,3659,358,591,588,3068,0.06032777777777778,0
MTURK,6c418c234637a262f4b3cc8fbb2ab683,3JU8CV4BRLDSMD84MXNPQ2NG8MOPOQ,0.04,0.0,Panel,7200,987,3749,366,594,621,3155,0.06082777777777778,0
MTURK,6c418c234637a262f4b3cc8fbb2ab683,3UAU495MIIT5EIG03JMJ08AFG3GOUL,0.04,0.0,Panel,7200,1007,3749,386,616,621,3133,0.06082777777777778,0
MTURK,6c418c234637a262f4b3cc8fbb2ab683,3S8A4GJRD34F2RZW8DAUFUQ79AW6V4,0.04,0.0,Panel,7200,1003,3720,387,597,616,3123,0.06066666666666667,0
MTURK,6c418c234637a262f4b3cc8fbb2ab683,3WUVMVA7OB4XYDG9ZNG9G55PT4SAZY,0.04,0.0,Panel,7200,1091,4140,401,600,690,3540,0.063,0
MTURK,6c418c234637a262f4b3cc8fbb2ab683,3LVTFB9DE5JPUCSLYRP6LY4OMWKGQM,0.04,0.0,Panel,7200,1126,4200,417,582,709,3618,0.06333333333333334,0
MTURK,6c418c234637a262f4b3cc8fbb2ab683,33J5JKFMK6ZO00GX3CIM24FFIRD3QZ,0.08,0.0,Panel,7200,1177,4200,429,559,748,3641,0.12666666666666668,0
MTURK,6c418c234637a262f4b3cc8fbb2ab683,367O8HRHKG9LVCEEVUCA79MMEFX4SD,0.08,0.0,Panel,7200,1200,4170,446,539,754,3631,0.12633333333333335,0
MTURK,6c418c234637a262f4b3cc8fbb2ab683,3DA79LNS59W1SG8PKGCH79Q22YG3TH,0.08,0.0,Panel,7200,1198,4110,446,511,752,3599,0.12566666666666668,0
MTURK,6c418c234637a262f4b3cc8fbb2ab683,3HJ1EVZS2OKOC1VXGR7M7UPKEDLR3U,0.08,0.0,Panel,7200,1219,3845,462,489,757,3356,0.12272222222222223,0
MTURK,6c418c234637a262f4b3cc8fbb2ab683,3UUSLRKAUL4CCADF02FSFMKW4EC7D5,0.04,0.0,Panel,7200,1143,3149,447,388,696,2761,0.057494444444444445,0
MTURK,6c418c234637a262f4b3cc8fbb2ab683,34ZTTGSNJXP3U8NWIX7O6YGP1W3HQS,0.04,0.0,Panel,7200,1222,3479,456,405,766,3074,0.05932777777777778,0
MTURK,6c418c234637a262f4b3cc8fbb2ab683,3BFF0DJK8X7JD554NX8W8JXHC9LSTX,0.07,0.0,Upside Services Inc,3600,248,750,139,247,109,503,0.08458333333333334,1
MTURK,6c418c234637a262f4b3cc8fbb2ab683,32ZCLEW0BZLEL2H76KVKI66U9SDJP0,0.06,0.0,Panel,7200,1064,2854,373,190,691,2664,0.08378333333333333,0
MTURK,6c418c234637a262f4b3cc8fbb2ab683,30UZJB2POHDZ7EXZJKUJ4TKOMVY53W,0.06,0.0,Panel,7200,1110,3089,383,246,727,2843,0.08574166666666666,0
MTURK,6c418c234637a262f4b3cc8fbb2ab683,3IZVJEBJ6ALWBB469AZX0033XL46Z6,0.04,0.0,Panel,7200,1068,2850,351,205,717,2645,0.05583333333333333,0
MTURK,6c418c234637a262f4b3cc8fbb2ab683,3SU800BH86T8ZUTGIWENPD5FV4YQUV,0.08,0.0,Panel,7200,1042,2732,347,321,695,2411,0.11035555555555555,0
MTURK,6c418c234637a262f4b3cc8fbb2ab683,3QGTX7BCHP30S74S4RPS8UP31QOZ5E,0.08,0.0,Panel,7200,884,2251,321,351,563,1900,0.10501111111111111,0
MTURK,6c418c234637a262f4b3cc8fbb2ab683,3LVTFB9DE5JPUCSLYRP6LY4OMXTGQX,0.04,0.0,Panel,7200,747,1800,275,146,472,1654,0.05,0
MTURK,6c418c234637a262f4b3cc8fbb2ab683,32TMVRKDGNZ3CSZ5HW65QIML2LN48A,0.08,0.0,Panel,7200,696,1713,248,165,448,1548,0.09903333333333333,0
MTURK,6c418c234637a262f4b3cc8fbb2ab683,3K3IX1W4S6S3K9E3CEI7P73BJ5RAPJ,0.04,0.0,Panel,7200,625,1470,238,146,387,1324,0.04816666666666667,0
MTURK,6c418c234637a262f4b3cc8fbb2ab683,3FBEFUUYRK6VA3WYXIJYJ7CUO14A6I,0.08,0.0,Panel,7200,401,900,133,123,268,777,0.09,0
MTURK,6c418c234637a262f4b3cc8fbb2ab683,35F6NGNVM8KJTZ9CMSF7KQ2I71AT7M,0.04,0.0,Panel,7200,322,629,118,139,204,490,0.04349444444444445,0
MTURK,6c418c234637a262f4b3cc8fbb2ab683,38F60IALAGI5BO9S1TUY5BSVZN60TV,0.04,1.0,Panel,7200,85,240,47,69,38,171,0.04133333333333333,0
MTURK,6c418c234637a262f4b3cc8fbb2ab683,3B623HUYJ4RMED1G7X2NOL2RG1R8SM,0.08,0.0,Panel,7200,60,90,30,9,30,81,0.081,0
MTURK,6c418c234637a262f4b3cc8fbb2ab683,3UEBBGULPFPB85374G3TDE11O31UFJ,0.04,1.0,Panel,7200,42,120,27,34,15,86,0.04066666666666667,0
MTURK,6c418c234637a262f4b3cc8fbb2ab683,30Y6N4AHYPXMUTXU9GDYK3BW5Q8DRC,0.04,0.0,Panel,7200,475,4141,68,469,407,3672,0.06300555555555556,0
MTURK,6c418c234637a262f4b3cc8fbb2ab683,32XN26MTXZKHSB1NSKS7JKIE59CL03,0.08,2.0,Panel,7200,411,4051,68,467,343,3584,0.12501111111111113,0
MTURK,6c418c234637a262f4b3cc8fbb2ab683,3FK4G712NX14XXGPLV8S5C2SSWCSSM,0.06,0.0,Panel,7200,476,4260,105,511,371,3749,0.0955,0
MTURK,6c418c234637a262f4b3cc8fbb2ab683,3RQVKZ7ZRKKP90FZ3DVBJ3TS7O172C,0.04,0.0,Panel,7200,384,4080,91,504,293,3576,0.06266666666666668,0
MTURK,6c418c234637a262f4b3cc8fbb2ab683,3ZUE82NE0A2DA8WU1D2OHMJCRCCF8R,0.08,0.0,Panel,7200,396,4110,104,477,292,3633,0.12566666666666668,0
MTURK,6c418c234637a262f4b3cc8fbb2ab683,3IV1AEQ4DRETFAIQK3T9WKB4KJS8JM,0.04,0.0,Panel,7200,413,4111,121,488,292,3623,0.06283888888888889,0
MTURK,6c418c234637a262f4b3cc8fbb2ab683,3MYASTQBG7CMISIUW1OYFD1R94AQDS,0.08,0.0,Panel,7200,378,3840,133,465,245,3375,0.12266666666666667,0
MTURK,6c418c234637a262f4b3cc8fbb2ab683,3OCZWXS7ZO8GNINOPQYJ0FE5MIY5LL,0.04,0.0,Panel,7200,371,3660,150,475,221,3185,0.060333333333333336,0
MTURK,6c418c234637a262f4b3cc8fbb2ab683,3I6NF2WGIGX01Q9NEZ13NN9XQ16G5K,0.08,0.0,Panel,7200,376,3181,160,452,216,2729,0.11534444444444444,0
MTURK,6c418c234637a262f4b3cc8fbb2ab683,3X2LT8FDHWJFLUIPR2COLA5CMF48WK,0.08,0.0,Panel,7200,516,3391,168,401,348,2990,0.11767777777777778,0
MTURK,6c418c234637a262f4b3cc8fbb2ab683,3O4VWC1GEW77EDCK8MYD533T4X3J38,0.04,0.0,Panel,7200,571,3480,207,399,364,3081,0.059333333333333335,0
MTURK,6c418c234637a262f4b3cc8fbb2ab683,3FSEU3P2NR1GV3GZRH8IPSS0KSDRRC,0.04,0.0,Panel,7200,635,3540,252,382,383,3158,0.05966666666666667,0
MTURK,6c418c234637a262f4b3cc8fbb2ab683,3PUV2Q8SV45ZEMG5DJR8KO6SN5KBDE,0.08,0.0,Panel,7200,670,3513,271,360,399,3153,0.11903333333333334,0
MTURK,6c418c234637a262f4b3cc8fbb2ab683,3X2YVV51PU5XAUY4SH3960I489ZW1P,0.08,0.0,Panel,7200,710,3691,297,383,413,3308,0.12101111111111112,0
MTURK,6c418c234637a262f4b3cc8fbb2ab683,34KYK9TV2R95GBZNA9MXFNSSO8VSBQ,0.06,0.0,Panel,7200,701,3270,301,367,400,2903,0.08725,0
MTURK,6c418c234637a262f4b3cc8fbb2ab683,3WRKFXQBOB8CZ5P2FP63JWK60JCIY4,0.08,0.0,Panel,7200,724,3095,316,324,408,2771,0.1143888888888889,0
MTURK,6c418c234637a262f4b3cc8fbb2ab683,3M67TQBQQHPISMYWVPMA3H3WE2MA93,0.04,0.0,Panel,7200,657,1741,309,306,348,1435,0.04967222222222222,0
MTURK,6c418c234637a262f4b3cc8fbb2ab683,3KG2UQJ0MJPV4497LV21BIDLN9QNQN,0.04,0.0,Panel,7200,635,1862,284,305,351,1557,0.05034444444444444,0
MTURK,6c418c234637a262f4b3cc8fbb2ab683,3JTPR5MTZSD53C564QMILF1QXIY5KN,0.04,0.0,Panel,7200,596,1651,260,221,336,1430,0.04917222222222222,0
MTURK,6c418c234637a262f4b3cc8fbb2ab683,31JUPBOORN5ZA06QNO5MCZOWO828LT,0.04,0.0,Panel,7200,641,1682,281,244,360,1438,0.04934444444444445,0
MTURK,6c418c234637a262f4b3cc8fbb2ab683,3HFWPF5AK9K0DGVAVG7RX4UG0GL3SD,0.08,0.0,Panel,7200,660,1771,282,243,378,1528,0.09967777777777778,0
MTURK,6c418c234637a262f4b3cc8fbb2ab683,302U8RURJZ2N9C5O7UWBH5CT414VNO,0.04,0.0,Panel,7200,638,2190,264,329,374,1861,0.05216666666666667,0
MTURK,6c418c234637a262f4b3cc8fbb2ab683,3ZURAPD288OVZ8C92ST92CW4D5T1FE,0.08,1.0,Panel,7200,499,1800,253,387,246,1413,0.1,0
MTURK,6c418c234637a262f4b3cc8fbb2ab683,3JGHED38FHAOALCB3WG1Y1Q9T9GY7V,0.5,1.0,Cortland Davidson,3600,48,90,34,31,14,59,0.5125,0
MTURK,6c418c234637a262f4b3cc8fbb2ab683,3WKGUBL7SZNYRZJOBLF9VN8RMM9L42,0.04,0.0,Panel,7200,453,1680,223,297,230,1383,0.04933333333333333,0
MTURK,6c418c234637a262f4b3cc8fbb2ab683,39RRBHZ0AU2HQ1J7AI75CSJ2EFEZVB,0.04,0.0,Panel,7200,441,1688,215,287,226,1401,0.04937777777777778,0
MTURK,6c418c234637a262f4b3cc8fbb2ab683,3ZXNP4Z39RMVAM17DJDGYZS1DO07L9,0.08,0.0,Panel,7200,502,1740,245,294,257,1446,0.09933333333333333,0
MTURK,6c418c234637a262f4b3cc8fbb2ab683,3PN6H8C9R4RUVCBD75RCPDMM5MNDA7,0.06,0.0,Panel,7200,497,1680,245,280,252,1400,0.074,0
MTURK,6c418c234637a262f4b3cc8fbb2ab683,3I4E7AFQ2K0CDUAEN144NG7RYWLTJ4,0.06,0.0,Panel,7200,471,1589,235,309,236,1280,0.07324166666666666,0
MTURK,6c418c234637a262f4b3cc8fbb2ab683,3T2HW4QDUV86L1VUF3I19CTKE5A9C7,0.08,0.0,Panel,7200,431,1500,215,348,216,1152,0.09666666666666666,0
MTURK,6c418c234637a262f4b3cc8fbb2ab683,31ANT7FQN83E1M4YY5JL8NLY51WH5X,0.04,0.0,Panel,7200,308,1109,160,248,148,861,0.04616111111111111,0
MTURK,6c418c234637a262f4b3cc8fbb2ab683,3MJ9GGZYO377S2DXAG7VTUVI8WFA2E,0.04,0.0,Panel,7200,328,1049,169,246,159,803,0.04582777777777778,0
MTURK,6c418c234637a262f4b3cc8fbb2ab683,307FVKVSYRGZCEUM7REZCIQQR2547D,0.04,1.0,Panel,7200,353,1078,180,229,173,849,0.04598888888888889,0
MTURK,6c418c234637a262f4b3cc8fbb2ab683,3WRAAIUSBJ08TIGUY5SOJKPEL1RAXS,0.08,0.0,Panel,7200,360,778,189,185,171,593,0.08864444444444444,0
MTURK,6c418c234637a262f4b3cc8fbb2ab683,3X878VYTIEJ9AURBR8AI3MNHGSEF7C,0.08,0.0,Panel,7200,298,840,159,261,139,579,0.08933333333333333,0
MTURK,6c418c234637a262f4b3cc8fbb2ab683,3DFYDSXB2W1RD7P3N6UESCTTHAKJUD,0.04,0.0,Panel,7200,234,660,122,207,112,453,0.043666666666666666,0
MTURK,6c418c234637a262f4b3cc8fbb2ab683,3VADEH0UHCY7K50XTE4YA7XH5CEPSC,0.08,0.0,Panel,7200,214,599,103,160,111,439,0.08665555555555556,0
MTURK,6c418c234637a262f4b3cc8fbb2ab683,38Z7YZ2SB333Q3YGOFP96AH41AYQIC,0.04,0.0,Panel,7200,117,269,63,139,54,130,0.041494444444444445,0
MTURK,6c418c234637a262f4b3cc8fbb2ab683,3EHIMLB7F70XO4N0W3QOK7VP7RY8HR,0.04,0.0,Panel,7200,117,269,63,139,54,130,0.041494444444444445,0
MTURK,6c418c234637a262f4b3cc8fbb2ab683,3KVQ0UJWPXMWYCZNT45L9QVLKORW5S,0.08,0.0,Panel,7200,114,180,63,88,51,92,0.082,0
MTURK,6c418c234637a262f4b3cc8fbb2ab683,3X2LT8FDHWJFLUIPR2COLA5CMFB8WR,0.08,12.0,Panel,7200,106,179,61,72,45,107,0.08198888888888889,0
MTURK,6c418c234637a262f4b3cc8fbb2ab683,3MVY4USGB6OF3JDTGJEE1AW5JYKISU,0.04,0.0,Panel,7200,43,120,24,76,19,44,0.04066666666666667,0
MTURK,6c418c234637a262f4b3cc8fbb2ab683,36D1BWBEHN28U3MM7JX02LQI2D42MQ,0.04,0.0,Panel,7200,59,56,15,18,44,38,0.04031111111111111,0
MTURK,6c418c234637a262f4b3cc8fbb2ab683,39O0SQZVJN12LE0W55YRXKJLWR17RB,0.5,0.0,Jane,900,166,450,44,63,122,387,0.75,1
MTURK,6c418c234637a262f4b3cc8fbb2ab683,3X7837UUADZ6BWZ2ROWBC6FDEOH6JD,0.04,0.0,Panel,7200,40,120,16,61,24,59,0.04066666666666667,0
MTURK,6c418c234637a262f4b3cc8fbb2ab683,3TTPFEFXCTLAKQ4C3OTQ0TZY1WDH6J,0.08,0.0,Panel,7200,57,179,26,45,31,134,0.08198888888888889,0
MTURK,6c418c234637a262f4b3cc8fbb2ab683,3P6ENY9P79XQDAZD5P2FXWP3AN8HID,0.04,0.0,Panel,7200,156,422,52,27,104,395,0.04234444444444445,0
MTURK,6c418c234637a262f4b3cc8fbb2ab683,3Y3CZJSZ9KURQGI1UAVFMRN4SAZ5RN,0.08,0.0,Panel,7200,108,271,36,77,72,194,0.08301111111111112,0
MTURK,6c418c234637a262f4b3cc8fbb2ab683,3CIS7GGG65KJ2R3B95JNVWG1C23UEI,0.04,0.0,Panel,7200,129,299,42,80,87,219,0.041661111111111114,0
MTURK,6c418c234637a262f4b3cc8fbb2ab683,3BPP3MA3TCLGJ1GH0RRM49KIZBALEF,0.04,0.0,Panel,7200,356,5250,47,331,309,4919,0.06916666666666667,0
MTURK,6c418c234637a262f4b3cc8fbb2ab683,3SBX2M1TLHBS9FLKS4B0QKYXD8R4Q7,0.7,0.0,Youngsoo Kim,259200,6835,5611,1906,2975,4929,2636,0.7151531635802468,0
MTURK,6c418c234637a262f4b3cc8fbb2ab683,3S8APUMBJXKWC6U14PMY8O9DZICBF1,0.04,0.0,Panel,7200,462,7089,120,645,342,6444,0.07938333333333333,0
MTURK,6c418c234637a262f4b3cc8fbb2ab683,385MDVINFCG45BE8I69FA0EQ2QAWJ4,0.04,0.0,Panel,7200,491,6660,145,624,346,6036,0.07700000000000001,0
MTURK,6c418c234637a262f4b3cc8fbb2ab683,32TMVRKDGNZ3CSZ5HW65QIML2MI84B,0.04,0.0,Panel,7200,490,5971,155,572,335,5399,0.07317222222222222,0
MTURK,6c418c234637a262f4b3cc8fbb2ab683,37J05LC5AXK5W5EH1B4PICP5VA5DJD,0.04,0.0,Panel,7200,513,5970,166,550,347,5420,0.07316666666666667,0
MTURK,6c418c234637a262f4b3cc8fbb2ab683,39HYCOOPKOMVXDK248HHY4HMZ40DMH,0.08,0.0,Panel,7200,558,5970,193,519,365,5451,0.14633333333333334,0
MTURK,6c418c234637a262f4b3cc8fbb2ab683,3AQN9REUTFHVRU9GNB5SSZ4T8EBYDP,0.08,0.0,Panel,7200,586,5940,207,497,379,5443,0.14600000000000002,0
MTURK,6c418c234637a262f4b3cc8fbb2ab683,3J9UN9O9J4CEQZANL9OMGSKTM9DJ01,0.4,0.0,Magnus,3600,132,881,58,271,74,610,0.49788888888888894,0
MTURK,6c418c234637a262f4b3cc8fbb2ab683,3ICOHX7ENCC3M5RVBY536PSUWDYE0Y,0.08,0.0,Panel,7200,411,3267,159,805,252,2462,0.1163,0
MTURK,6c418c234637a262f4b3cc8fbb2ab683,31ANT7FQN83E1M4YY5JL8NLY514H55,0.04,0.0,Panel,7200,416,2976,148,198,268,2778,0.05653333333333334,0
MTURK,6c418c234637a262f4b3cc8fbb2ab683,344M16OZKIG671J2C471H1O746CENC,0.04,0.0,Panel,7200,431,2999,156,199,275,2800,0.056661111111111113,0
MTURK,6c418c234637a262f4b3cc8fbb2ab683,3JVP4ZJHDPTF2ATH7HVUR4QMO690IX,0.04,0.0,Panel,7200,418,2759,152,160,266,2599,0.05532777777777778,0
MTURK,6c418c234637a262f4b3cc8fbb2ab683,362E9TQF2HRCDE42LJKXCWD2VNXIGH,0.04,0.0,Panel,7200,456,2879,179,196,277,2683,0.055994444444444444,0
MTURK,6c418c234637a262f4b3cc8fbb2ab683,3T8DUCXY0N7N7IX51PDRYMTO2RIT9I,0.04,0.0,Panel,7200,524,3029,215,202,309,2827,0.05682777777777778,0
MTURK,6c418c234637a262f4b3cc8fbb2ab683,3AJA9FLWSCZ6ZE87AZEFUBDQU8XIFI,0.04,0.0,Panel,7200,519,3029,210,202,309,2827,0.05682777777777778,0
MTURK,6c418c234637a262f4b3cc8fbb2ab683,31KPKEKW4AE5F2FB173D5HM9TGP0BO,0.04,0.0,Panel,7200,536,3029,219,197,317,2832,0.05682777777777778,0
MTURK,6c418c234637a262f4b3cc8fbb2ab683,3XAOZ9UYRZSSQX2IG843EB0IK8W1Q4,0.08,0.0,Panel,7200,546,2427,243,196,303,2231,0.10696666666666667,0
MTURK,6c418c234637a262f4b3cc8fbb2ab683,3OEWW2KGQJCJXG5EHOWUQ86RU4HDOY,0.04,0.0,Panel,7200,149,300,85,56,64,244,0.041666666666666664,0
MTURK,6c418c234637a262f4b3cc8fbb2ab683,3Z8UJEJOCZEI81ZBMA70G9PQ8SE93Q,0.04,0.0,Panel,7200,64,210,15,29,49,181,0.04116666666666667,0
MTURK,6c418c234637a262f4b3cc8fbb2ab683,31KSVEGZ34TL3ZXLQBIOCR0HC7HRW4,0.04,0.0,Panel,7200,43,90,21,13,22,77,0.0405,0
MTURK,6c418c234637a262f4b3cc8fbb2ab683,3CVBMEMMXBB7PYUHZ0TWZ9YXE2W7H0,0.07,0.0,Upside Services Inc,3600,251,750,42,150,209,600,0.08458333333333334,1
MTURK,6c418c234637a262f4b3cc8fbb2ab683,38RHULDV9YG8A0U20OOFYZZQPB0IWT,0.04,47.0,Panel,7200,228,1710,36,177,192,1533,0.0495,0
MTURK,6c418c234637a262f4b3cc8fbb2ab683,3RDTX9JRTY209K0YOMAQTQ16DU497Z,0.04,0.0,Panel,7200,271,1920,52,209,219,1711,0.050666666666666665,0
MTURK,6c418c234637a262f4b3cc8fbb2ab683,3MD8CKRQZZOZXFXMJCZ9N169ABAJR3,0.04,0.0,Panel,7200,324,2250,73,226,251,2024,0.052500000000000005,0
MTURK,6c418c234637a262f4b3cc8fbb2ab683,3X55NP42EOH30OFI3Z3X2ZP5DW0P35,0.08,2.0,Panel,7200,346,2280,86,228,260,2052,0.10533333333333333,0
MTURK,6c418c234637a262f4b3cc8fbb2ab683,3A3KKYU7P3IU6JKTL3M7QS676KKMWD,0.04,0.0,Panel,7200,346,2460,91,222,255,2238,0.05366666666666667,0
MTURK,6c418c234637a262f4b3cc8fbb2ab683,341H3G5YF0F1X0IR7LJGRZTCKJO0Z7,0.04,0.0,Panel,7200,411,2610,120,200,291,2410,0.0545,0
MTURK,6c418c234637a262f4b3cc8fbb2ab683,3D0LPO3EAB0MVR05DKJ83TGSCS0OYU,0.08,0.0,Panel,7200,443,2582,155,207,288,2375,0.10868888888888889,0
MTURK,6c418c234637a262f4b3cc8fbb2ab683,3B9XR6P1WEWCH8GXNFDJNM15SQ9BJM,0.08,0.0,Panel,7200,454,2523,167,207,287,2316,0.10803333333333334,0
MTURK,6c418c234637a262f4b3cc8fbb2ab683,3RQVKZ7ZRKKP90FZ3DVBJ3TS7PX275,0.08,0.0,Panel,7200,520,2613,188,198,332,2415,0.10903333333333334,0
MTURK,6c418c234637a262f4b3cc8fbb2ab683,3LAZVA75NISWU67YKZCDUPFNXE72OV,0.08,0.0,Panel,7200,554,2642,201,199,353,2443,0.10935555555555557,0
MTURK,6c418c234637a262f4b3cc8fbb2ab683,3JGHED38EDSFAL86WY26S7UXM4RY7H,0.06,0.0,Panel,7200,677,3060,239,250,438,2810,0.08549999999999999,0
MTURK,6c418c234637a262f4b3cc8fbb2ab683,3FJ2RVH25Z7TNJ3SIATVXZKY2FL92O,0.08,0.0,Panel,7200,717,3060,261,238,456,2822,0.114,0
MTURK,6c418c234637a262f4b3cc8fbb2ab683,3LVTFB9DE5JPUCSLYRP6LY4OMXNQG1,0.08,0.0,Panel,7200,705,3030,261,226,444,2804,0.11366666666666667,0
MTURK,6c418c234637a262f4b3cc8fbb2ab683,39O6Z4JLX2YSL6JS90JKF73R6G5VX1,0.06,0.0,Panel,7200,748,3090,278,217,470,2873,0.08574999999999999,0
MTURK,6c418c234637a262f4b3cc8fbb2ab683,3BC9H1KCYUDU009746AIKNTEFV0YWJ,0.08,0.0,Panel,7200,766,3090,287,195,479,2895,0.11433333333333334,0
MTURK,6c418c234637a262f4b3cc8fbb2ab683,33P2GD6NRNTHJ5P15SNRAC4G2SGHK9,0.06,0.0,Panel,7200,810,3390,305,232,505,3158,0.08825,0
MTURK,6c418c234637a262f4b3cc8fbb2ab683,3PMR2DOWOO2KPAG3JYZ2EYCU0X054R,0.06,0.0,Panel,7200,857,3510,330,225,527,3285,0.08925,0
MTURK,6c418c234637a262f4b3cc8fbb2ab683,37VHPF5VYC467WCKABCN9GY9U0N8CE,0.06,0.0,Panel,7200,737,2220,306,322,431,1898,0.0785,0
MTURK,6c418c234637a262f4b3cc8fbb2ab683,3YGYP13641AVG5O7YAR1G8NQJWLNRJ,0.04,0.0,Panel,7200,771,2250,320,249,451,2001,0.052500000000000005,0
MTURK,6c418c234637a262f4b3cc8fbb2ab683,3TL87MO8CMQ8PFGDV2BSMR5IBDEFLI,0.04,0.0,Panel,7200,771,2250,320,248,451,2002,0.052500000000000005,0
MTURK,6c418c234637a262f4b3cc8fbb2ab683,32TZXEA1OLLL1SFKIBXQB8ZDOH114B,0.04,0.0,Panel,7200,842,2430,339,314,503,2116,0.0535,0
MTURK,6c418c234637a262f4b3cc8fbb2ab683,338GLSUI43CVTSB3FB8TYDJD37ESF1,0.06,0.0,Panel,7200,701,1738,273,219,428,1519,0.07448333333333333,0
MTURK,6c418c234637a262f4b3cc8fbb2ab683,3I4E7AFQ2K0CDUAEN144NG7RYXGTJ1,0.04,0.0,Panel,7200,572,1560,203,159,369,1401,0.048666666666666664,0
MTURK,6c418c234637a262f4b3cc8fbb2ab683,3X0EMNLXEPQNCXH1N993LUHO4H4VPL,0.04,0.0,Panel,7200,611,1499,210,152,401,1347,0.048327777777777775,0
MTURK,6c418c234637a262f4b3cc8fbb2ab683,3S8A4GJRD34F2RZW8DAUFUQ79CDV6E,0.06,0.0,Panel,7200,677,1562,217,125,460,1437,0.07301666666666666,0
MTURK,6c418c234637a262f4b3cc8fbb2ab683,3UOMW19E6D7NKETICD5KXWOISAGC5A,0.08,0.0,Panel,7200,779,1831,239,129,540,1702,0.10034444444444444,0
MTURK,6c418c234637a262f4b3cc8fbb2ab683,3EHIMLB7F70XO4N0W3QOK7VP7SPH8T,0.08,0.0,Panel,7200,750,1743,230,175,520,1568,0.09936666666666667,0
MTURK,6c418c234637a262f4b3cc8fbb2ab683,3FTID4TN8LZEP6X80S3GBCCYHO2LYJ,0.04,0.0,Panel,7200,715,1620,206,120,509,1500,0.049,0
MTURK,6c418c234637a262f4b3cc8fbb2ab683,33W1NHWFYHM2D9FI5N7QBAVHHVUTZN,0.04,0.0,Panel,7200,887,2821,228,190,659,2631,0.05567222222222222,0
MTURK,6c418c234637a262f4b3cc8fbb2ab683,3SR6AEG6W5UC3AEI97OIJKJR064YHY,0.08,6.0,Panel,7200,966,3240,246,332,720,2908,0.116,0
MTURK,6c418c234637a262f4b3cc8fbb2ab683,3D4BBDG7ZHXK6Z6EYUHRIZQYEET3CF,0.04,4.0,Panel,7200,1011,3242,263,313,748,2929,0.05801111111111111,0
MTURK,6c418c234637a262f4b3cc8fbb2ab683,3PR3LXCWSF0UOZ6P6ZEONPEUFOP9X2,0.08,0.0,Panel,7200,1022,3030,274,323,748,2707,0.11366666666666667,0
MTURK,6c418c234637a262f4b3cc8fbb2ab683,3ODOP6T3ASLSQDXG1FX4GR9IGNC42S,0.06,0.0,Panel,7200,815,2640,197,292,618,2348,0.082,0
MTURK,6c418c234637a262f4b3cc8fbb2ab683,31S7M7DAGGRI8KYEQMGH3VKJ2MOLTY,0.08,0.0,Panel,7200,365,1470,107,270,258,1200,0.09633333333333334,0
MTURK,6c418c234637a262f4b3cc8fbb2ab683,3DTJ4WT8BDG0OQXLFSIVCOVGEL7ZE3,0.08,0.0,Panel,7200,361,1500,123,328,238,1172,0.09666666666666666,0
MTURK,6c418c234637a262f4b3cc8fbb2ab683,31ANT7FQN83E1M4YY5JL8NLY52TH5W,0.04,0.0,Panel,7200,492,4951,145,508,347,4443,0.06750555555555555,0
MTURK,6c418c234637a262f4b3cc8fbb2ab683,30P8I9JKOIMJJNZI3U0PNOC7DH6V52,0.04,1.0,Panel,7200,525,5040,172,546,353,4494,0.068,0
MTURK,6c418c234637a262f4b3cc8fbb2ab683,3QHITW7OYOAOKLFICRXWPCTLO3SQA9,0.04,1.0,Panel,7200,525,5040,172,546,353,4494,0.068,0
MTURK,6c418c234637a262f4b3cc8fbb2ab683,3ATYLI1PRT3W0256RKI5T614ZP2OJD,0.06,0.0,Panel,7200,546,4890,190,534,356,4356,0.10075,0
MTURK,6c418c234637a262f4b3cc8fbb2ab683,3DA79LNS59W1SG8PKGCH79Q22003T5,0.04,0.0,Panel,7200,500,4798,172,507,328,4291,0.06665555555555555,0
MTURK,6c418c234637a262f4b3cc8fbb2ab683,3J5XXLQDHMCG58CEPBCW8RENZLD3VI,0.04,0.0,Panel,7200,545,5370,187,557,358,4813,0.06983333333333333,0
MTURK,6c418c234637a262f4b3cc8fbb2ab683,3QE4DGPGBRCI575N0UITIV3JQ6HG4N,0.04,0.0,Panel,7200,546,5220,192,517,354,4703,0.069,0
MTURK,6c418c234637a262f4b3cc8fbb2ab683,3DW3BNF1GHJ265IK1S7SZ8MYF798VJ,0.08,0.0,Panel,7200,634,5883,206,514,428,5369,0.14536666666666667,0
MTURK,6c418c234637a262f4b3cc8fbb2ab683,3LXX8KJXPWA7UQSX58RS4CN13KU9O7,0.04,0.0,Panel,7200,689,5945,236,474,453,5471,0.07302777777777777,0
MTURK,6c418c234637a262f4b3cc8fbb2ab683,3HUR21WDDUQ9P0EXEB64M67LOXIXYN,0.04,0.0,Panel,7200,657,5914,226,461,431,5453,0.07285555555555556,0
MTURK,6c418c234637a262f4b3cc8fbb2ab683,3AC6MFV69KJC80ON5TQ1XRST614ZHO,0.08,0.0,Panel,7200,671,6034,239,488,432,5546,0.14704444444444445,0
MTURK,6c418c234637a262f4b3cc8fbb2ab683,3FVBZG9CLJFF6FIX1ZD9RSP7OT70HH,0.04,0.0,Panel,7200,671,6034,239,488,432,5546,0.07352222222222222,0
MTURK,6c418c234637a262f4b3cc8fbb2ab683,30IRMPJWDZKU8Z341XZLOG6MP1ERKG,0.08,0.0,Panel,7200,659,5943,227,456,432,5487,0.14603333333333335,0
MTURK,6c418c234637a262f4b3cc8fbb2ab683,31D0ZWOD0A00WSAJVT3HA623BZXA0Y,0.04,0.0,Panel,7200,635,5823,219,456,416,5367,0.07235,0
MTURK,6c418c234637a262f4b3cc8fbb2ab683,3B0MCRZMBRVA7DK51X04F2S6IT9PP0,0.06,0.0,Panel,7200,689,5883,242,458,447,5425,0.109025,0
MTURK,6c418c234637a262f4b3cc8fbb2ab683,3U18MJKL1UNRA3ZOGD16RDO4JVTNCO,0.04,0.0,Panel,7200,796,6153,271,460,525,5693,0.07418333333333334,0
MTURK,6c418c234637a262f4b3cc8fbb2ab683,3D06DR5225KXZ6HQKYQF839GE2YMAL,0.04,0.0,Panel,7200,758,5973,255,410,503,5563,0.07318333333333334,0
MTURK,6c418c234637a262f4b3cc8fbb2ab683,36AZSFEYZ41L83GR44R2QACZNDWBVN,0.04,0.0,Panel,7200,803,6034,275,385,528,5649,0.07352222222222222,0
MTURK,6c418c234637a262f4b3cc8fbb2ab683,3LG268AV387RMZBU5BOIQLTH54WERX,0.08,0.0,Panel,7200,838,6153,285,362,553,5791,0.14836666666666667,0
MTURK,6c418c234637a262f4b3cc8fbb2ab683,359AP8GAGGL27I7106KHVG2EJG97CI,0.06,0.0,Panel,7200,887,6184,306,354,581,5830,0.11153333333333333,0
MTURK,6c418c234637a262f4b3cc8fbb2ab683,3OKP4QVBP2YX7WL49VSKVYPJIGNAG2,0.06,0.0,Panel,7200,941,6215,335,354,606,5861,0.11179166666666666,0
MTURK,6c418c234637a262f4b3cc8fbb2ab683,3WUVMVA7OB4XYDG9ZNG9G55PT62ZA1,0.04,0.0,Panel,7200,938,6095,335,310,603,5785,0.07386111111111111,0
MTURK,6c418c234637a262f4b3cc8fbb2ab683,3TZDZ3Y0JS7MYYLWZ6THSGATA9C91C,0.08,0.0,Panel,7200,959,6063,352,317,607,5746,0.14736666666666667,0
MTURK,6c418c234637a262f4b3cc8fbb2ab683,3MA5N0ATTCCZGVKQ0R9RBFE3HG5KWO,0.04,0.0,Panel,7200,1093,3574,392,364,701,3210,0.05985555555555556,0
MTURK,6c418c234637a262f4b3cc8fbb2ab683,3AC6MFV69KJC80ON5TQ1XRST619ZHT,0.04,0.0,Panel,7200,1019,3453,348,259,671,3194,0.05918333333333334,0
MTURK,6c418c234637a262f4b3cc8fbb2ab683,3MQY1YVHS46EYLER65GUDSW54NLB2S,1.0,1.0,HBS Behavioral Research,3600,955,2942,322,205,633,2737,1.817222222222222,0
MTURK,6c418c234637a262f4b3cc8fbb2ab683,39I4RL8QGJIW530YK00B3VFK5684HO,0.04,0.0,Panel,7200,936,2614,334,557,602,2057,0.05452222222222222,0
MTURK,6c418c234637a262f4b3cc8fbb2ab683,3M93N4X8HKOBYUXZY1ZEDBB5WE9JS9,0.04,0.0,Panel,7200,647,1500,235,151,412,1349,0.04833333333333333,0
MTURK,6c418c234637a262f4b3cc8fbb2ab683,3IVEC1GSLP0B4AY5LIKUHAOW6EM1JX,0.08,0.0,Panel,7200,26,30,15,13,11,17,0.08033333333333334,0
MTURK,6c418c234637a262f4b3cc8fbb2ab683,31MCUE39BKNXNBMJ0GDA8QBDC65G3M,0.06,0.0,Panel,7200,204,570,51,96,153,474,0.06475,0
MTURK,6c418c234637a262f4b3cc8fbb2ab683,3KA7IJSNW6683JJVISI3KINH1P5BPC,0.04,0.0,Panel,7200,85,180,25,13,60,167,0.041,0
MTURK,6c418c234637a262f4b3cc8fbb2ab683,367O8HRHKG9LVCEEVUCA79MMEHUS42,0.06,0.0,Panel,7200,73,89,36,10,37,79,0.060741666666666666,0
MTURK,6c418c234637a262f4b3cc8fbb2ab683,3W0XM68YZPW6FU4N33K6IPO9L37K10,0.04,0.0,Panel,7200,66,428,21,40,45,388,0.04237777777777778,0
MTURK,6c418c234637a262f4b3cc8fbb2ab683,34F34TZU7W0ITVG14MK8MTY1YKN2J2,0.06,0.0,Panel,7200,297,1094,84,219,213,875,0.06911666666666666,1
MTURK,6c418c234637a262f4b3cc8fbb2ab683,3WRAAIUSBJ06NIN4MP5KPGGCUA6AXX,0.5,0.0,Philip J. Lalone,1800,121,599,47,155,74,444,0.6663888888888889,1
MTURK,6c418c234637a262f4b3cc8fbb2ab683,304QEQWKZPLPYW4K5C8ZB1M80GCO0M,0.06,0.0,Panel,7200,261,929,78,117,183,812,0.06774166666666666,1
MTURK,6c418c234637a262f4b3cc8fbb2ab683,3SX4X51T809X5N3EE5EBIGDZG0AOAT,0.9,0.0,Lara Kirfel,7200,456,6568,99,269,357,6299,1.721,1
MTURK,6c418c234637a262f4b3cc8fbb2ab683,3J5XXLQDHMCG58CEPBCW8RENZL5V32,0.08,0.0,Panel,7200,278,5978,66,217,212,5761,0.14642222222222223,0
MTURK,6c418c234637a262f4b3cc8fbb2ab683,3C8QQOM6JP2SZ6I3WAHDPOIAR50LI9,0.08,0.0,Panel,7200,252,5731,88,287,164,5444,0.1436777777777778,0
MTURK,6c418c234637a262f4b3cc8fbb2ab683,3SA4EMRVJV37JWGLKCLE01RYALI0PP,0.06,0.0,Panel,7200,376,1830,83,793,293,1037,0.07525,0
MTURK,6c418c234637a262f4b3cc8fbb2ab683,3XU9MCX6VODZRJZECRTHOKKS81W2R9,0.06,0.0,Panel,7200,380,1259,96,1331,284,-72,0.07049166666666666,0
MTURK,6c418c234637a262f4b3cc8fbb2ab683,3J5XXLQDHMCG58CEPBCW8RENZLNV3K,0.08,0.0,Panel,7200,376,1110,96,1479,280,-369,0.09233333333333334,0
MTURK,6c418c234637a262f4b3cc8fbb2ab683,3VMHWJRYHVH3P9X29LEGXL05IM9XF7,0.08,0.0,Panel,7200,340,2010,25,50,315,1960,0.10233333333333333,0
MTURK,6c418c234637a262f4b3cc8fbb2ab683,3LXX8KJXPWA7UQSX58RS4CN13KA9ON,0.06,0.0,Panel,7200,151,900,23,11,128,889,0.0675,0
MTURK,6c418c234637a262f4b3cc8fbb2ab683,3X52SWXE0W4V9IIBQDSKIY29574WCC,0.35,1.0,Melanie MacEacheron,600,136,600,63,91,73,509,0.7,0
MTURK,6c418c234637a262f4b3cc8fbb2ab683,3MZ3TAMYTLO324DG1UE9B0R9XY3IRC,0.08,2.0,Panel,7200,132,510,63,46,69,464,0.08566666666666667,0
MTURK,6c418c234637a262f4b3cc8fbb2ab683,3MDWE879UH39MACGRPDDWVJUU7C9B1,1.0,0.0,Debra Oswald,7200,545,3661,204,409,341,3252,1.5084722222222222,0
MTURK,6c418c234637a262f4b3cc8fbb2ab683,33KMQD9OFLHP4KZ9KAMKN9BDTVY776,0.3,1.0,Xingyu Liu,3600,133,1080,67,104,66,976,0.39,1
MTURK,6c418c234637a262f4b3cc8fbb2ab683,3R5OYNIC2CA8Z5DCIE9OKCT37XRPT4,0.08,0.0,Panel,7200,406,3001,144,309,262,2692,0.11334444444444444,0
MTURK,6c418c234637a262f4b3cc8fbb2ab683,30P8I9JKOIMJJNZI3U0PNOC7DIE5VM,0.06,0.0,Panel,7200,405,2971,144,309,261,2662,0.08475833333333332,0
MTURK,6c418c234637a262f4b3cc8fbb2ab683,3Q7TKIAPOTBBRV2H4WG2YR2XZ16LDN,0.08,0.0,Panel,7200,430,2340,162,298,268,2042,0.10600000000000001,0
MTURK,6c418c234637a262f4b3cc8fbb2ab683,38XPGNCKHT11N4VIPPHFIW6TDMJV47,0.08,0.0,Panel,7200,355,1921,118,189,237,1732,0.10134444444444445,0
MTURK,6c418c234637a262f4b3cc8fbb2ab683,32CXT5U14G42TQTKW2XN3MKF11U8UQ,0.08,0.0,Panel,7200,324,1590,116,143,208,1447,0.09766666666666667,0
MTURK,6c418c234637a262f4b3cc8fbb2ab683,3TC2K6WK9G3T9EKIDINHX3PNIAO28F,0.04,3.0,Panel,7200,233,991,49,119,184,872,0.045505555555555556,0
MTURK,6c418c234637a262f4b3cc8fbb2ab683,309D674SHZMP9UARDNWX0IOA27PBCZ,0.06,0.0,Panel,7200,351,4407,62,121,289,4286,0.096725,0
MTURK,6c418c234637a262f4b3cc8fbb2ab683,3V7ICJJAZAHMEQXCK8QFHKCMAU84BF,0.04,1.0,Panel,7200,375,4409,72,109,303,4300,0.06449444444444445,0
MTURK,6c418c234637a262f4b3cc8fbb2ab683,3HO4MYYR12PFPCAW3N0PJ8OOV6I6UG,0.04,0.0,Panel,7200,470,4502,124,154,346,4348,0.06501111111111112,0
MTURK,6c418c234637a262f4b3cc8fbb2ab683,37VE3DA4YUIGQ2L7ZFAYB9LQFZEBHS,0.08,0.0,Panel,7200,468,4472,124,153,344,4319,0.1296888888888889,0
MTURK,6c418c234637a262f4b3cc8fbb2ab683,3IKMEYR0LWWD4FMJM7KKN8YEDAAK28,0.04,0.0,Panel,7200,507,4531,137,158,370,4373,0.06517222222222223,0
MTURK,6c418c234637a262f4b3cc8fbb2ab683,341H3G5YF0F1X0IR7LJGRZTCKLF0Z2,0.04,0.0,Panel,7200,524,4322,147,168,377,4154,0.06401111111111112,0
MTURK,6c418c234637a262f4b3cc8fbb2ab683,3FDWKV9VCN3HEFVOQ37684LAL60UMH,0.04,0.0,Panel,7200,569,4411,178,176,391,4235,0.06450555555555557,0
MTURK,6c418c234637a262f4b3cc8fbb2ab683,3J9UN9O9J3TBXLDNPZGU355M1N1J0Z,0.04,0.0,Panel,7200,610,4500,196,210,414,4290,0.065,0
MTURK,6c418c234637a262f4b3cc8fbb2ab683,3XH7ZM9YX2VAR3KDX08WY7S6E8Q9RU,0.08,0.0,Panel,7200,649,4681,205,232,444,4449,0.1320111111111111,0
MTURK,6c418c234637a262f4b3cc8fbb2ab683,3CVBMEMMXBHTOQIHMYYI67ZUW947HJ,0.04,0.0,Panel,7200,732,4832,252,236,480,4596,0.06684444444444444,0
MTURK,6c418c234637a262f4b3cc8fbb2ab683,3MQKOF1EE2PR2PEG8AN472JDX8KDWI,0.04,0.0,Panel,7200,731,4802,252,207,479,4595,0.06667777777777778,0
MTURK,6c418c234637a262f4b3cc8fbb2ab683,3IVKZBIBJ0AF7O29A1WT1YVQJNHSHR,0.04,0.0,Panel,7200,735,4800,269,214,466,4586,0.06666666666666667,0
MTURK,6c418c234637a262f4b3cc8fbb2ab683,3BS6ERDL938T8AZAHSA098K096RD6H,0.04,0.0,Panel,7200,760,5037,297,246,463,4791,0.06798333333333334,0
MTURK,6c418c234637a262f4b3cc8fbb2ab683,3CVBMEMMXBHTOQIHMYYI67ZUW94H7T,0.04,0.0,Panel,7200,771,5101,313,277,458,4824,0.0683388888888889,0
MTURK,6c418c234637a262f4b3cc8fbb2ab683,3MQY1YVHS3LCBCIPGU7RO5FOQGEB2S,0.08,1.0,Panel,7200,860,5762,375,768,485,4994,0.14402222222222222,0
MTURK,6c418c234637a262f4b3cc8fbb2ab683,34R3P23QHS28E5JIU66UYNYBP0EHWW,0.04,0.0,Panel,7200,916,5825,411,789,505,5036,0.07236111111111111,0
MTURK,6c418c234637a262f4b3cc8fbb2ab683,3J6BHNX0U9T9T1BC8QI4FW1CO5EKNC,0.04,0.0,Panel,7200,896,5795,411,789,485,5006,0.07219444444444445,0
MTURK,6c418c234637a262f4b3cc8fbb2ab683,3K8CQCU3KE20O15TX41737V7BCNNWB,0.04,0.0,Panel,7200,928,5880,427,812,501,5068,0.07266666666666667,0
MTURK,6c418c234637a262f4b3cc8fbb2ab683,32TZXEA1OLLL1SFKIBXQB8ZDOIK14W,0.04,0.0,Panel,7200,1040,6956,495,1468,545,5488,0.07864444444444445,0
MTURK,6c418c234637a262f4b3cc8fbb2ab683,3AXFSPQOYQZ2UPSDSHZF6CSQ7PSJF5,0.04,0.0,Panel,7200,1063,7017,507,1471,556,5546,0.07898333333333334,0
MTURK,6c418c234637a262f4b3cc8fbb2ab683,30P8I9JKOIMJJNZI3U0PNOC7DI8V56,0.08,0.0,Panel,7200,1124,6989,539,1465,585,5524,0.15765555555555555,0
MTURK,6c418c234637a262f4b3cc8fbb2ab683,359AP8GAGGL27I7106KHVG2EJHZC7F,0.06,0.0,Panel,7200,1124,6990,539,1465,585,5525,0.11825,0
MTURK,6c418c234637a262f4b3cc8fbb2ab683,3BCRDCM0ODV1MG5K99WNDLFQTFQ6KP,0.06,0.0,Panel,7200,1164,7017,554,1466,610,5551,0.118475,0
MTURK,6c418c234637a262f4b3cc8fbb2ab683,3SNR5F7R92UET08BFOU9CTSQI9PEI7,0.08,0.0,Panel,7200,1195,7077,569,1469,626,5608,0.15863333333333335,0
MTURK,6c418c234637a262f4b3cc8fbb2ab683,3VIVIU06FKDC5O0OWMISP1XZRBGMI4,0.04,0.0,Panel,7200,1147,7078,558,1459,589,5619,0.07932222222222222,0
MTURK,6c418c234637a262f4b3cc8fbb2ab683,3QREJ3J433YJ518RWD2P24XNJAKKLG,0.04,0.0,Panel,7200,1074,3630,577,1473,497,2157,0.06016666666666667,0
MTURK,6c418c234637a262f4b3cc8fbb2ab683,3ACRLU860N923D28WVI8AVKMUTKEBK,0.4,1.0,Huachao Gao,3600,714,3001,406,1393,308,1608,0.7334444444444446,0
MTURK,6c418c234637a262f4b3cc8fbb2ab683,3AXFSPQOYQZ2UPSDSHZF6CSQ7PUFJ3,0.04,0.0,Panel,7200,954,3508,514,1426,440,2082,0.05948888888888889,0
MTURK,6c418c234637a262f4b3cc8fbb2ab683,33IXYHIZB5JAIFU9QL9HPDL9TDD2E5,0.08,0.0,Panel,7200,992,3511,534,1438,458,2073,0.11901111111111112,0
MTURK,6c418c234637a262f4b3cc8fbb2ab683,3IHWR4LC7DEXKZYK2L89KJW47718IE,0.04,0.0,Panel,7200,931,3421,517,1492,414,1929,0.05900555555555556,0
MTURK,6c418c234637a262f4b3cc8fbb2ab683,3QE4DGPGBRCI575N0UITIV3JQ784G4,0.06,0.0,Panel,7200,916,3359,504,1416,412,1943,0.08799166666666666,0
MTURK,6c418c234637a262f4b3cc8fbb2ab683,3O0M2G5VC633QXIFMOCJQEHWMVI94P,0.04,0.0,Panel,7200,906,3392,497,1462,409,1930,0.05884444444444445,0
MTURK,6c418c234637a262f4b3cc8fbb2ab683,3P4C70TRMRIE3FC86MHA4C5UCU7GLF,0.04,0.0,Panel,7200,929,3360,507,1451,422,1909,0.05866666666666667,0
MTURK,6c418c234637a262f4b3cc8fbb2ab683,3VGET1QSZ00BLGD6HXKI7A9HBXXW7O,0.04,0.0,Panel,7200,905,3093,496,1419,409,1674,0.057183333333333336,0
MTURK,6c418c234637a262f4b3cc8fbb2ab683,3X0EMNLXEPQNCXH1N993LUHO4JXPVC,0.04,0.0,Panel,7200,902,3210,480,1428,422,1782,0.057833333333333334,0
MTURK,6c418c234637a262f4b3cc8fbb2ab683,371Q3BEXDHA1Y923GN2015ZVFEAZS2,0.04,0.0,Panel,7200,965,3394,497,1431,468,1963,0.05885555555555556,0
MTURK,6c418c234637a262f4b3cc8fbb2ab683,3A9LA2FRWSFN35O84B2G06CIY25XHQ,0.08,0.0,Panel,7200,970,3360,492,1458,478,1902,0.11733333333333335,0
MTURK,6c418c234637a262f4b3cc8fbb2ab683,3P7RGTLO6EE29IHNZMDZTQHCPYJKAW,0.04,0.0,Panel,7200,970,3181,478,1394,492,1787,0.05767222222222222,0
MTURK,6c418c234637a262f4b3cc8fbb2ab683,306996CF6WL5MR0TXQ7DJM5JYBCB1P,0.06,1.0,Panel,7200,916,2850,435,1150,481,1700,0.08374999999999999,0
MTURK,6c418c234637a262f4b3cc8fbb2ab683,374UMBUHN5QP5G48D9NI0CUW8ERTC9,0.04,0.0,Panel,7200,888,2458,406,866,482,1592,0.053655555555555554,0
MTURK,6c418c234637a262f4b3cc8fbb2ab683,3K1H3NEY7L0V53OGT5JMLZXP3KNGDF,0.06,0.0,Panel,7200,806,1771,366,1052,440,719,0.07475833333333333,0
MTURK,6c418c234637a262f4b3cc8fbb2ab683,3MWOYZD5WVPSJSWR6IAXMDIL8BXNOA,0.06,1.0,Panel,7200,806,1561,366,1053,440,508,0.07300833333333333,0
MTURK,6c418c234637a262f4b3cc8fbb2ab683,3VLL1PIENQPM0HAA96LRH0PUIOWZOS,0.08,0.0,Panel,7200,829,1502,378,1055,451,447,0.0966888888888889,0
MTURK,6c418c234637a262f4b3cc8fbb2ab683,3XABXM4AJ16A1XM3FTDITLNQYHIQ8Z,0.04,0.0,Panel,7200,492,885,210,154,282,731,0.04491666666666667,0
MTURK,6c418c234637a262f4b3cc8fbb2ab683,3RIHDBQ1NEZC9TP4Q407PPWKRZDMHP,0.04,0.0,Panel,7200,470,856,197,143,273,713,0.044755555555555555,0
MTURK,6c418c234637a262f4b3cc8fbb2ab683,37SOB9Z0SSYD930KB7AQLIGL8P13LT,0.04,0.0,Panel,7200,487,843,205,149,282,694,0.04468333333333333,0
MTURK,6c418c234637a262f4b3cc8fbb2ab683,3D1UCPY6GGAIUWG1HI1MGDUFOOA38D,0.08,0.0,Panel,7200,500,811,210,109,290,702,0.08901111111111111,0
MTURK,6c418c234637a262f4b3cc8fbb2ab683,30QQTY5GMKLYTCO1MX5HPMOKQILU7O,0.04,0.0,Panel,7200,403,1593,17,50,386,1543,0.048850000000000005,0
MTURK,6c418c234637a262f4b3cc8fbb2ab683,3G57RS03HH6AMW1GFKGELJFWGLD255,0.08,0.0,Panel,7200,424,1440,25,36,399,1404,0.096,0
MTURK,6c418c234637a262f4b3cc8fbb2ab683,3RIHDBQ1NEZC9TP4Q407PPWKRY4HM9,0.06,0.0,Panel,7200,475,1470,41,79,434,1391,0.07225,0
MTURK,6c418c234637a262f4b3cc8fbb2ab683,3XT3KXP24ZZAGLFW96BB050D1CNI6E,0.04,0.0,Panel,7200,203,630,35,61,168,569,0.043500000000000004,0
MTURK,6c418c234637a262f4b3cc8fbb2ab683,3G4VVJO6PZH9WMNPO5VWJL67OL2KPX,0.06,0.0,Panel,7200,231,599,55,69,176,530,0.06499166666666667,0
MTURK,6c418c234637a262f4b3cc8fbb2ab683,3VDI8GSXAFUJO8SPCX86Z7JOSULG86,0.08,0.0,Panel,7200,222,540,53,28,169,512,0.08600000000000001,0
MTURK,6c418c234637a262f4b3cc8fbb2ab683,3G9UA71JVVVPFWD7AY13IKF992UJ7O,0.04,0.0,Panel,7200,228,708,69,119,159,589,0.04393333333333334,0
MTURK,6c418c234637a262f4b3cc8fbb2ab683,3N7PQ0KLI5QZ3XQSULNM8NQ1ZRH3EL,0.08,1.0,Panel,7200,178,510,76,115,102,395,0.08566666666666667,0
MTURK,6c418c234637a262f4b3cc8fbb2ab683,3X7837UUADZ6BWZ2ROWBC6FDERCJ6R,0.04,0.0,Panel,7200,78,210,36,50,42,160,0.04116666666666667,0
MTURK,6c418c234637a262f4b3cc8fbb2ab683,3ZQA3IO31BSP5LP21VCZP65I592O1B,0.08,0.0,Panel,7200,90,4230,26,1264,64,2966,0.127,0
MTURK,6c418c234637a262f4b3cc8fbb2ab683,3T2EL38U0ML0GYNBN1PA9K4JPQ4XQR,0.04,0.0,Panel,7200,72,1922,31,1259,41,663,0.05067777777777778,0
MTURK,6c418c234637a262f4b3cc8fbb2ab683,31GN6YMHLPTX4EXY50IT215DYCJSWI,0.06,0.0,Panel,7200,90,1950,39,1248,51,702,0.07625,0
MTURK,6c418c234637a262f4b3cc8fbb2ab683,31HLTCK4BLWHZKO2KQJGRL3W3SNGVC,0.04,0.0,Panel,7200,154,1860,75,1132,79,728,0.050333333333333334,0
MTURK,6c418c234637a262f4b3cc8fbb2ab683,3W0XM68YZPW6FU4N33K6IPO9L5Y1KC,0.08,0.0,Panel,7200,154,1260,75,532,79,728,0.094,0
MTURK,6c418c234637a262f4b3cc8fbb2ab683,3L84EBDQ3738LVQ9BDQON4K8UBMKKM,0.08,0.0,Panel,7200,154,1080,75,353,79,727,0.092,0
MTURK,6c418c234637a262f4b3cc8fbb2ab683,3909MD9T2ZIUJ96LEGOO9WFY2ILEF6,0.06,0.0,Panel,7200,180,1055,81,295,99,760,0.06879166666666667,0
MTURK,6c418c234637a262f4b3cc8fbb2ab683,3126F2F5F846AMVFSJKTLQT24O9EPA,0.06,0.0,Panel,7200,50,210,13,28,37,182,0.06175,1
MTURK,6c418c234637a262f4b3cc8fbb2ab683,31KSVEGZ34NZ479L3DD25TZKU33WRQ,0.07,0.0,Upside Services Inc,3600,56,270,21,223,35,47,0.07525000000000001,1
MTURK,6c418c234637a262f4b3cc8fbb2ab683,3PGQRAZX02L1TJSYK10HNYQT9KZSYX,0.04,45.0,Panel,7200,120,1560,40,137,80,1423,0.048666666666666664,1
MTURK,6c418c234637a262f4b3cc8fbb2ab683,3DW3BNF1GHJ265IK1S7SZ8MYF9R8V5,0.04,52.0,Panel,7200,141,1560,56,123,85,1437,0.048666666666666664,0
MTURK,6c418c234637a262f4b3cc8fbb2ab683,3LN3BXKGC0WUE9O7A0OCDNMAA15WGI,0.06,1.0,Panel,7200,161,1595,67,125,94,1470,0.07329166666666667,0
MTURK,6c418c234637a262f4b3cc8fbb2ab683,3RWO3EJELHA7QL13GVPEE6A8FFK1PT,0.04,48.0,Panel,7200,186,1680,81,154,105,1526,0.04933333333333333,0
MTURK,6c418c234637a262f4b3cc8fbb2ab683,34O39PNDK69TFWZAVKMSPDNW29ZBRE,0.04,44.0,Panel,7200,202,1710,88,155,114,1555,0.0495,0
MTURK,6c418c234637a262f4b3cc8fbb2ab683,3HKIF5DF6YYJ2DBZHPEKZ3EZC0L9G6,0.04,50.0,Panel,7200,258,1830,126,160,132,1670,0.050166666666666665,0
MTURK,6c418c234637a262f4b3cc8fbb2ab683,30Y6N4AHYPXMUTXU9GDYK3BW5UBRD1,0.04,50.0,Panel,7200,258,1830,126,160,132,1670,0.050166666666666665,0
MTURK,6c418c234637a262f4b3cc8fbb2ab683,3FCO4VKOZ4EH4GRFWXQCL42H4UI7EB,0.04,24.0,Panel,7200,311,2070,157,304,154,1766,0.051500000000000004,0
MTURK,6c418c234637a262f4b3cc8fbb2ab683,3S1L4CQSFX6RTWP9YBM2DDP7H33FAS,0.04,41.0,Panel,7200,306,2040,157,303,149,1737,0.051333333333333335,0
MTURK,6c418c234637a262f4b3cc8fbb2ab683,3XBYQ44Z6P5YJEADU0NJC61Z0VEWTS,0.04,0.0,Panel,7200,404,2402,206,378,198,2024,0.053344444444444444,0
MTURK,6c418c234637a262f4b3cc8fbb2ab683,3EPG8DX9LKR6E32MHIRQHWNPRVPP5Z,0.04,2.0,Panel,7200,404,2402,206,378,198,2024,0.053344444444444444,0
MTURK,6c418c234637a262f4b3cc8fbb2ab683,3UL5XDRDNCKL8B35V1PFVASZ2LP58V,0.08,0.0,Panel,7200,408,2430,209,378,199,2052,0.107,0
MTURK,6c418c234637a262f4b3cc8fbb2ab683,3QQUBC64ZEFFD1AJ79XT5Q9EKFYNXB,0.04,1.0,Panel,7200,430,2430,225,379,205,2051,0.0535,0
MTURK,6c418c234637a262f4b3cc8fbb2ab683,32PT7WK7DMGUBRCSYQC2258GZGW3DA,0.04,1.0,Panel,7200,430,2430,225,379,205,2051,0.0535,0
MTURK,6c418c234637a262f4b3cc8fbb2ab683,3E22YV8GG17A4S8SLINCBDNBIGPPNP,0.04,0.0,Panel,7200,535,4802,250,438,285,4364,0.06667777777777778,0
MTURK,6c418c234637a262f4b3cc8fbb2ab683,3M67TQBQQHPISMYWVPMA3H3WE599AV,0.08,2.0,Panel,7200,578,4770,277,449,301,4321,0.133,0
MTURK,6c418c234637a262f4b3cc8fbb2ab683,3VZYA8PITOZ3QMY20XC02VMHJNE509,0.06,0.0,Panel,7200,578,4770,277,449,301,4321,0.09975,0
MTURK,6c418c234637a262f4b3cc8fbb2ab683,3VW0145YLYD80ZKUE43S12CZ4RAJMK,0.04,0.0,Panel,7200,626,4830,304,453,322,4377,0.06683333333333333,0
MTURK,6c418c234637a262f4b3cc8fbb2ab683,3OYHVNTV5TZRBMBO95IHUL1HEGPKOZ,0.06,0.0,Panel,7200,617,4800,304,452,313,4348,0.1,0
MTURK,6c418c234637a262f4b3cc8fbb2ab683,3LB1BGHFL2X28J5D9157X3MFB3FYTU,0.06,0.0,Panel,7200,614,4740,304,452,310,4288,0.0995,0
MTURK,6c418c234637a262f4b3cc8fbb2ab683,3ROUCZ907FVA1DW37XAA12IQYL0OOO,0.08,0.0,Panel,7200,621,7229,311,2787,310,4442,0.16032222222222223,0
MTURK,6c418c234637a262f4b3cc8fbb2ab683,373L46LKP77DABKRTSQCMPKVFMGKJH,0.08,0.0,Panel,7200,619,7199,309,2758,310,4441,0.1599888888888889,0
MTURK,6c418c234637a262f4b3cc8fbb2ab683,3SR6AEG6W5UC3AEI97OIJKJR09LHY4,0.06,0.0,Panel,7200,620,7199,310,2758,310,4441,0.11999166666666666,0
MTURK,6c418c234637a262f4b3cc8fbb2ab683,307L9TDWJYT3X335NKQ5YAKADKZN3D,0.06,0.0,Panel,7200,620,7199,310,2758,310,4441,0.11999166666666666,0
MTURK,6c418c234637a262f4b3cc8fbb2ab683,35YHTYFL1G4BLKS796DY903K2D6FVV,0.06,16.0,Panel,7200,619,7199,310,2733,309,4466,0.11999166666666666,0
MTURK,6c418c234637a262f4b3cc8fbb2ab683,3H6W48L9F4Q0RMH6DJEZ7W02BT5PWU,0.06,0.0,Panel,7200,579,7229,302,3844,277,3385,0.12024166666666666,0
MTURK,6c418c234637a262f4b3cc8fbb2ab683,38RHULDV9YG8A0U20OOFYZZQPFAWIP,0.04,2.0,Panel,7200,533,7224,275,3840,258,3384,0.08013333333333333,0
MTURK,6c418c234637a262f4b3cc8fbb2ab683,3JUDR1D0D6SZFIKEZC4HJUANCIO2Q8,0.04,2.0,Panel,7200,533,7224,275,3840,258,3384,0.08013333333333333,0
MTURK,6c418c234637a262f4b3cc8fbb2ab683,3N7PQ0KLI5QZ3XQSULNM8NQ1ZT4E3N,0.04,0.0,Panel,7200,508,7229,261,3811,247,3418,0.08016111111111111,0
MTURK,6c418c234637a262f4b3cc8fbb2ab683,3ICOHX7ENCC3M5RVBY536PSUWGCE0I,0.04,1.0,Panel,7200,490,7229,252,3814,238,3415,0.08016111111111111,0
MTURK,6c418c234637a262f4b3cc8fbb2ab683,3QREJ3J433YJ518RWD2P24XNJCTLKU,0.04,2.0,Panel,7200,425,7199,216,3809,209,3390,0.07999444444444445,0
MTURK,6c418c234637a262f4b3cc8fbb2ab683,341YLJU21I0MYKWVM4Z8ASJ1L8CI2Q,0.04,1.0,Panel,7200,416,7199,213,3838,203,3361,0.07999444444444445,0
MTURK,6c418c234637a262f4b3cc8fbb2ab683,3Y40HMYLL1JS8RUS4A9FJL18SBSXUE,0.04,0.0,Panel,7200,373,7199,186,3662,187,3537,0.07999444444444445,0
MTURK,6c418c234637a262f4b3cc8fbb2ab683,3D4BBDG7ZHXK6Z6EYUHRIZQYEHNC3O,0.08,3.0,Panel,7200,373,7199,186,3662,187,3537,0.1599888888888889,0
MTURK,6c418c234637a262f4b3cc8fbb2ab683,3P4ZBJFX2V4O09SCZGIUV2MY9M5WFJ,0.04,0.0,Panel,7200,279,7197,141,3585,138,3612,0.07998333333333334,0
MTURK,6c418c234637a262f4b3cc8fbb2ab683,3VQTAXTYN3MLVORRZEHXUOAG99CUBC,0.04,0.0,Panel,7200,276,7227,138,3584,138,3643,0.08015,0
MTURK,6c418c234637a262f4b3cc8fbb2ab683,3FO95NVK5C1SWIGC668NF2XW6YVRS7,0.04,0.0,Panel,7200,214,7199,108,3578,106,3621,0.07999444444444445,0
MTURK,6c418c234637a262f4b3cc8fbb2ab683,3OID399FXG8PR3SLILD43EXD279DF3,0.08,17.0,Panel,7200,211,7199,107,3562,104,3637,0.1599888888888889,0
MTURK,6c418c234637a262f4b3cc8fbb2ab683,3L4YG5VW9NTSTJEPRFIEFEUSQUVDDU,0.08,0.0,Panel,7200,210,7199,107,3530,103,3669,0.1599888888888889,0
MTURK,6c418c234637a262f4b3cc8fbb2ab683,3RQVKZ7ZRKKP90FZ3DVBJ3TS7R127D,0.08,0.0,Panel,7200,195,5702,113,3543,82,2159,0.14335555555555557,0
MTURK,6c418c234637a262f4b3cc8fbb2ab683,3LOJFQ4BOXG07PKZJW41JRPIA3MDK1,0.08,0.0,Panel,7200,126,5462,68,3534,58,1928,0.1406888888888889,0
MTURK,6c418c234637a262f4b3cc8fbb2ab683,32LAQ1JNT9QLRAL8Z08IUIG2FG9UTZ,0.08,0.0,Panel,7200,167,5430,83,3452,84,1978,0.14033333333333334,0
MTURK,6c418c234637a262f4b3cc8fbb2ab683,3VDVA3ILIDG1D884DCZRKXWGEPB1G5,0.04,0.0,Panel,7200,206,5430,102,3432,104,1998,0.07016666666666667,0
MTURK,6c418c234637a262f4b3cc8fbb2ab683,3XU80RHWHZH2TRC35TGS966G04C44Y,0.04,1.0,Panel,7200,269,5760,128,3457,141,2303,0.07200000000000001,0
MTURK,6c418c234637a262f4b3cc8fbb2ab683,391JB9X4ZY93BJQCWP342HCCJHOKM0,0.06,0.0,Panel,7200,297,5280,143,2807,154,2473,0.10400000000000001,0
MTURK,6c418c234637a262f4b3cc8fbb2ab683,3YO4AH2FPDLSJ8H0KP0306H8FKIQ0Q,0.04,0.0,Panel,7200,328,4050,155,1433,173,2617,0.0625,0
MTURK,6c418c234637a262f4b3cc8fbb2ab683,3PIOQ99R7YNNWXGO24M6LJAAQYZUNA,0.06,0.0,Panel,7200,388,4199,186,1447,202,2752,0.09499166666666667,0
MTURK,6c418c234637a262f4b3cc8fbb2ab683,39KV3A5D188IEZWXXSAHAL6W5M9S7H,0.06,0.0,Panel,7200,415,4380,195,1451,220,2929,0.0965,0
MTURK,6c418c234637a262f4b3cc8fbb2ab683,3DZKABX2ZI64I88XI4NX1UIH51UVCI,0.04,5.0,Panel,7200,460,4409,222,1453,238,2956,0.06449444444444445,0
MTURK,6c418c234637a262f4b3cc8fbb2ab683,3D1TUISJWI1VIW5X5O9EGBET4Z6UIV,0.06,0.0,Panel,7200,460,4319,222,1363,238,2956,0.09599166666666667,0
MTURK,6c418c234637a262f4b3cc8fbb2ab683,38Z7YZ2SB333Q3YGOFP96AH41E5IQJ,0.04,5.0,Panel,7200,396,1408,192,263,204,1145,0.047822222222222224,0
MTURK,6c418c234637a262f4b3cc8fbb2ab683,33KGGVH24UICZU3U2MZV8JWBHFGX12,0.04,0.0,Panel,7200,396,1408,192,263,204,1145,0.047822222222222224,0
MTURK,6c418c234637a262f4b3cc8fbb2ab683,33W1NHWFYHM2D9FI5N7QBAVHHYWZT1,0.04,0.0,Panel,7200,399,1382,188,263,211,1119,0.04767777777777778,0
MTURK,6c418c234637a262f4b3cc8fbb2ab683,307L9TDWJYT3X335NKQ5YAKADLG3NC,0.06,0.0,Panel,7200,429,1410,204,272,225,1138,0.07175,0
MTURK,6c418c234637a262f4b3cc8fbb2ab683,3MDKGGG61QO0PZV73IAFEC2MCU4T69,0.06,0.0,Panel,7200,390,1381,185,257,205,1124,0.07150833333333333,0
MTURK,6c418c234637a262f4b3cc8fbb2ab683,341H3G5YF0F1X0IR7LJGRZTCKN6Z0W,0.04,0.0,Panel,7200,421,1381,204,261,217,1120,0.04767222222222223,0
MTURK,6c418c234637a262f4b3cc8fbb2ab683,3UXQ63NLAANICY4XQ0PW31EXWI3BLJ,0.04,0.0,Panel,7200,421,1381,204,261,217,1120,0.04767222222222223,0
MTURK,6c418c234637a262f4b3cc8fbb2ab683,3A3KKYU7P3IU6JKTL3M7QS676OWWM7,0.04,0.0,Panel,7200,452,1230,221,265,231,965,0.04683333333333334,0
MTURK,6c418c234637a262f4b3cc8fbb2ab683,32PT7WK7DMGUBRCSYQC2258GZHOD3E,0.04,0.0,Panel,7200,419,1050,200,243,219,807,0.04583333333333334,0
MTURK,6c418c234637a262f4b3cc8fbb2ab683,3Y7LTZE0YTNHDMU75SX0G6HJ0CIUZ2,0.04,0.0,Panel,7200,452,1045,220,219,232,826,0.04580555555555556,0
MTURK,6c418c234637a262f4b3cc8fbb2ab683,37VE3DA4YUIGQ2L7ZFAYB9LQF17BHP,0.08,0.0,Panel,7200,452,1045,220,219,232,826,0.09161111111111112,0
MTURK,6c418c234637a262f4b3cc8fbb2ab683,34R0BODSP102HCDW84BFNKOLDPGE5Y,0.04,1.0,Panel,7200,486,1050,238,199,248,851,0.04583333333333334,0
MTURK,6c418c234637a262f4b3cc8fbb2ab683,39I4RL8QGJIW530YK00B3VFK59SH4R,0.06,0.0,Panel,7200,422,510,206,156,216,354,0.06425,0
MTURK,6c418c234637a262f4b3cc8fbb2ab683,3SMIWMMK616DJRP2U5DTH2N1JAEWUE,0.06,11.0,Panel,7200,481,600,224,75,257,525,0.065,0
MTURK,6c418c234637a262f4b3cc8fbb2ab683,3MIVREZQVHZUWYO4OIALJQWHTIVQK3,0.06,11.0,Panel,7200,417,390,197,67,220,323,0.06325,0
MTURK,6c418c234637a262f4b3cc8fbb2ab683,3JHB4BPSFKAAF25DKLJWTHI1IOO9QX,0.06,0.0,Panel,7200,304,328,149,59,155,269,0.06273333333333334,0
MTURK,6c418c234637a262f4b3cc8fbb2ab683,3FI30CQHVKK0TD1Q3WJUEIW06NC6B4,0.08,0.0,Panel,7200,135,150,61,23,74,127,0.08166666666666667,0
MTURK,6c418c234637a262f4b3cc8fbb2ab683,371DNNCG443NTDEVWX7DYQYDIOC8TQ,0.08,0.0,Panel,7200,113,90,59,22,54,68,0.081,0
MTURK,6c418c234637a262f4b3cc8fbb2ab683,37PGLWGSJT7HF00LBA5CAO5V28JKIZ,0.06,0.0,Panel,7200,45,30,17,1,28,29,0.06025,0
MTURK,6c418c234637a262f4b3cc8fbb2ab683,3H1C3QRA01KNGXMBNEYN1QUV56BECF,0.06,0.0,Panel,7200,141,660,21,19,120,641,0.0655,1
MTURK,6c418c234637a262f4b3cc8fbb2ab683,37Y5RYYI0P6CTE2OF5EF4KJK7F9SXX,0.04,0.0,Panel,7200,98,270,27,10,71,260,0.0415,0
MTURK,6c418c234637a262f4b3cc8fbb2ab683,3XT3KXP24ZTOHTRWM86PT7ZGJ5WI6C,0.07,0.0,Upside Services Inc,3600,109,478,24,96,85,382,0.07929444444444445,1
MTURK,6c418c234637a262f4b3cc8fbb2ab683,39N6W9XWRDOY3EJ7P160YK7QLAXGYV,0.08,0.0,Panel,7200,264,5841,24,924,240,4917,0.1449,0
MTURK,6c418c234637a262f4b3cc8fbb2ab683,3HY86PZXPYJ3TUCD7H93KUB41961EY,0.06,0.0,Panel,7200,214,5513,41,928,173,4585,0.10594166666666667,0
MTURK,6c418c234637a262f4b3cc8fbb2ab683,36QZ6V1589EKCA8TA03SKDKGDX0SUD,0.08,0.0,Panel,7200,198,5423,41,927,157,4496,0.14025555555555555,0
MTURK,6c418c234637a262f4b3cc8fbb2ab683,3FW4EL5A3LPINZITX1EGNCCKWDA22W,0.04,0.0,Panel,7200,140,1220,50,928,90,292,0.04677777777777778,0
MTURK,6c418c234637a262f4b3cc8fbb2ab683,3MXX6RQ9EV6OIKYM3D8GC4HBR104PJ,0.04,0.0,Panel,7200,162,1189,61,841,101,348,0.04660555555555555,0
MTURK,6c418c234637a262f4b3cc8fbb2ab683,3EFNPKWBMSP0C7BYMEO7NYOX5SP03I,0.04,0.0,Panel,7200,208,1161,85,784,123,377,0.04645,0
MTURK,6c418c234637a262f4b3cc8fbb2ab683,38RHULDV9YG8A0U20OOFYZZQPFUIWV,0.06,0.0,Panel,7200,208,1101,85,724,123,377,0.069175,0
MTURK,6c418c234637a262f4b3cc8fbb2ab683,3C8QQOM6JP2SZ6I3WAHDPOIAR7UIL4,0.08,0.0,Panel,7200,226,1099,94,699,132,400,0.09221111111111112,0
MTURK,6c418c234637a262f4b3cc8fbb2ab683,3THR0FZ95PU2VST6U5UI9LEW3IXOLD,0.04,1.0,Panel,7200,172,210,92,29,80,181,0.04116666666666667,0
MTURK,6c418c234637a262f4b3cc8fbb2ab683,3EPG8DX9LKLKFBEMUKM4AYMS9OHP5G,0.07,0.0,Upside Services Inc,3600,102,2129,38,478,64,1651,0.11139722222222223,1
MTURK,6c418c234637a262f4b3cc8fbb2ab683,3B6F54KMR2D43DHV8CT89BFJ21Y1SK,0.06,0.0,Panel,7200,257,3780,187,2090,70,1690,0.0915,1
MTURK,6c418c234637a262f4b3cc8fbb2ab683,3FDWKV9VCN3HEFVOQ37684LAL9DMUS,0.04,0.0,Panel,7200,274,3777,202,2073,72,1704,0.060983333333333334,0
MTURK,6c418c234637a262f4b3cc8fbb2ab683,3PZDSVZ3J5IOFZM9NYVO8FCGRM04NO,0.04,0.0,Panel,7200,281,3750,211,2082,70,1668,0.060833333333333336,0
MTURK,6c418c234637a262f4b3cc8fbb2ab683,3FO95NVK5C1SWIGC668NF2XW6YJRSV,0.06,0.0,Panel,7200,337,3512,225,2076,112,1436,0.08926666666666666,0
MTURK,6c418c234637a262f4b3cc8fbb2ab683,3VO4XFFP15N61JHK5OLCFLRVNZD7QY,0.04,0.0,Panel,7200,358,3179,234,2035,124,1144,0.057661111111111114,0
MTURK,6c418c234637a262f4b3cc8fbb2ab683,3IZVJEBJ6ALWBB469AZX0033XQ46ZG,0.06,0.0,Panel,7200,423,3120,268,2002,155,1118,0.086,0
MTURK,6c418c234637a262f4b3cc8fbb2ab683,3ZXV7Q5FJBJTNJY7VRD7CAEYZZHCF9,0.07,0.0,Upside Services Inc,3600,114,1410,95,1016,19,394,0.09741666666666668,1
MTURK,6c418c234637a262f4b3cc8fbb2ab683,3EAWOID6MTSYPOPHJQPRZVFJE47V0M,0.07,0.0,Upside Services Inc,3600,145,2099,128,1647,17,452,0.1108138888888889,1
MTURK,6c418c234637a262f4b3cc8fbb2ab683,3U18MJKL1UNRA3ZOGD16RDO4JY3NC4,0.08,0.0,Panel,7200,406,2369,267,1928,139,441,0.10632222222222222,0
MTURK,6c418c234637a262f4b3cc8fbb2ab683,3YLPJ8OXX8ETRT0DP4IX6H3ET07X4Y,0.04,0.0,Panel,7200,380,2040,251,1747,129,293,0.051333333333333335,0
MTURK,6c418c234637a262f4b3cc8fbb2ab683,39HYCOOPKOG9YLW2HACVR6GPH04DMG,0.07,0.0,Upside Services Inc,3600,134,1680,126,1566,8,114,0.10266666666666668,1
MTURK,6c418c234637a262f4b3cc8fbb2ab683,3UQ1LLR26A9DTOZ5KMP08QURE1WLAE,0.06,5.0,Panel,7200,392,1827,247,1497,145,330,0.075225,0
MTURK,6c418c234637a262f4b3cc8fbb2ab683,3D42WVSDH8WSPENCEH0IGZ7EKWDYFW,0.04,0.0,Panel,7200,298,450,154,215,144,235,0.0425,0
MTURK,6c418c234637a262f4b3cc8fbb2ab683,3X0EMNLXEPQNCXH1N993LUHO4LAPVT,0.08,3.0,Panel,7200,45,600,17,58,28,542,0.08666666666666667,1
MTURK,6c418c234637a262f4b3cc8fbb2ab683,37S0QRNUFBH4VTM7TZWI7U2Q4DA88O,0.06,14.0,Panel,7200,122,361,31,86,91,275,0.06300833333333333,1
MTURK,6c418c234637a262f4b3cc8fbb2ab683,3HRWUH63QU36BIQ913EYD7IURI8N5P,0.04,1.0,Panel,7200,277,1650,67,134,210,1516,0.049166666666666664,1
MTURK,6c418c234637a262f4b3cc8fbb2ab683,3AXFSPQOYQZ2UPSDSHZF6CSQ7SHFJW,0.04,4.0,Panel,7200,286,1650,80,133,206,1517,0.049166666666666664,0
MTURK,6c418c234637a262f4b3cc8fbb2ab683,3PGQRAZX02L1TJSYK10HNYQT9MKSYM,0.04,10.0,Panel,7200,319,1830,93,163,226,1667,0.050166666666666665,0
MTURK,6c418c234637a262f4b3cc8fbb2ab683,3PCPFX4U40RJGCWQN7JO3D4CLN9FQN,0.04,7.0,Panel,7200,348,1889,108,164,240,1725,0.050494444444444446,0
MTURK,6c418c234637a262f4b3cc8fbb2ab683,3P520RYKCH7J68AIY4QKR2AOZE25U0,0.06,0.0,Panel,7200,376,1950,120,188,256,1762,0.07625,0
MTURK,6c418c234637a262f4b3cc8fbb2ab683,3IV1AEQ4DRETFAIQK3T9WKB4KO58J9,0.08,52.0,Panel,7200,418,2009,135,196,283,1813,0.10232222222222223,0
MTURK,6c418c234637a262f4b3cc8fbb2ab683,3S8APUMBJXKWC6U14PMY8O9DZN9BF8,0.04,0.0,Panel,7200,455,2219,148,212,307,2007,0.05232777777777778,0
MTURK,6c418c234637a262f4b3cc8fbb2ab683,3TZDZ3Y0JS7MYYLWZ6THSGATADN19N,0.06,0.0,Panel,7200,468,2220,158,209,310,2011,0.0785,0
MTURK,6c418c234637a262f4b3cc8fbb2ab683,3L21G7IH47X1ZZT47ILXRX3KJM81YC,0.08,0.0,Panel,7200,494,2220,175,212,319,2008,0.10466666666666667,0
MTURK,6c418c234637a262f4b3cc8fbb2ab683,3LEG2HW4UFO2OTU5LWTN7V695HWF2A,0.08,0.0,Panel,7200,494,2220,175,212,319,2008,0.10466666666666667,0
MTURK,6c418c234637a262f4b3cc8fbb2ab683,3A3KKYU7P3IU6JKTL3M7QS676P3MW6,0.04,0.0,Panel,7200,509,2189,184,178,325,2011,0.052161111111111116,0
MTURK,6c418c234637a262f4b3cc8fbb2ab683,36QZ6V1589EKCA8TA03SKDKGDYAUSR,0.06,0.0,Panel,7200,613,2393,228,193,385,2200,0.07994166666666666,0
MTURK,6c418c234637a262f4b3cc8fbb2ab683,3BFF0DJK8XD5CXT4AVDIFHYEUK3TSZ,0.06,0.0,Panel,7200,603,2369,228,191,375,2178,0.07974166666666667,0
MTURK,6c418c234637a262f4b3cc8fbb2ab683,3IQ9O0AYW60GIJQ85JJ4BFSRLM2ITX,0.06,0.0,Panel,7200,588,2341,227,190,361,2151,0.07950833333333333,0
MTURK,6c418c234637a262f4b3cc8fbb2ab683,3R15W654VDU5G46M9IMMYQ9WIJXQL5,0.08,3.0,Panel,7200,631,2370,251,175,380,2195,0.10633333333333334,0
MTURK,6c418c234637a262f4b3cc8fbb2ab683,3IZVJEBJ6ALWBB469AZX0033XRU6Z8,0.08,3.0,Panel,7200,598,2310,241,186,357,2124,0.10566666666666667,0
MTURK,6c418c234637a262f4b3cc8fbb2ab683,3QO7EE372OOT3VKAI5XSKNDR6PKBQ4,0.08,0.0,Panel,7200,623,2371,253,190,370,2181,0.10634444444444445,0
MTURK,6c418c234637a262f4b3cc8fbb2ab683,307FVKVSYRGZCEUM7REZCIQQR7B74W,0.08,0.0,Panel,7200,647,2374,267,221,380,2153,0.10637777777777778,0
MTURK,6c418c234637a262f4b3cc8fbb2ab683,3YLTXLH3DF7IUWMHIKSZ6TQFW63PH7,0.04,0.0,Panel,7200,713,2432,281,251,432,2181,0.05351111111111111,0
MTURK,6c418c234637a262f4b3cc8fbb2ab683,3X0EMNLXEPQNCXH1N993LUHO4LEPVX,0.04,0.0,Panel,7200,757,2464,301,258,456,2206,0.05368888888888889,0
MTURK,6c418c234637a262f4b3cc8fbb2ab683,3O4VWC1GEW77EDCK8MYD533T42G3JF,0.06,1.0,Panel,7200,793,2431,312,319,481,2112,0.08025833333333333,0
MTURK,6c418c234637a262f4b3cc8fbb2ab683,39O6Z4JLX2YSL6JS90JKF73R6KNVXR,0.06,0.0,Panel,7200,751,2403,299,317,452,2086,0.080025,0
MTURK,6c418c234637a262f4b3cc8fbb2ab683,3Y3N5A7N4GAYVOFT044VBPRNHX5YMJ,0.04,0.0,Panel,7200,901,2552,333,357,568,2195,0.05417777777777778,0
MTURK,6c418c234637a262f4b3cc8fbb2ab683,3W1K7D6QSBI2HNL151G5BGPVBS5ZBM,0.08,0.0,Panel,7200,1078,3089,356,364,722,2725,0.11432222222222223,0
MTURK,6c418c234637a262f4b3cc8fbb2ab683,336OE47KI2LDW6E2ZVNYDOPKXIIWV0,0.06,0.0,Panel,7200,1105,2970,373,493,732,2477,0.08474999999999999,0
MTURK,6c418c234637a262f4b3cc8fbb2ab683,33K3E8REWWWUAUNF178ANTJJVMV8X8,0.06,0.0,Panel,7200,992,1859,342,303,650,1556,0.07549166666666667,0
MTURK,6c418c234637a262f4b3cc8fbb2ab683,32CXT5U14G42TQTKW2XN3MKF14E8UG,0.04,0.0,Panel,7200,1035,1952,365,332,670,1620,0.05084444444444444,0
MTURK,6c418c234637a262f4b3cc8fbb2ab683,3RBI0I35XE4X927JUMZGFQIHH6WY3B,0.04,0.0,Panel,7200,1022,1921,357,141,665,1780,0.05067222222222222,0
MTURK,6c418c234637a262f4b3cc8fbb2ab683,3O4VWC1GEW77EDCK8MYD533T42PJ34,0.06,0.0,Panel,7200,1028,1860,362,144,666,1716,0.0755,0
MTURK,6c418c234637a262f4b3cc8fbb2ab683,31HLTCK4BLWHZKO2KQJGRL3W3U1GVU,0.08,0.0,Panel,7200,986,1770,348,119,638,1651,0.09966666666666667,0
MTURK,6c418c234637a262f4b3cc8fbb2ab683,35U0MRQMUJ85RX5089WOWUCYUGMVOQ,0.06,0.0,Panel,7200,979,1769,347,113,632,1656,0.07474166666666666,0
MTURK,6c418c234637a262f4b3cc8fbb2ab683,33QQ60S6ASJKB1OH1YK8A7EXI62U0F,0.04,0.0,Panel,7200,988,1649,347,106,641,1543,0.049161111111111114,0
MTURK,6c418c234637a262f4b3cc8fbb2ab683,3YGE63DIN8YX35DMWYZ9SVZU3MBW0E,0.04,0.0,Panel,7200,1011,1833,351,117,660,1716,0.05018333333333334,0
MTURK,6c418c234637a262f4b3cc8fbb2ab683,3QQUBC64ZEJV80APYDQNXQH7V2WXNB,0.25,60.0,Alan Ritter,1800,44,44,21,9,23,35,0.2561111111111111,0
MTURK,6c418c234637a262f4b3cc8fbb2ab683,3OPLMF3EU5OKD7TUTQU5UWERD8ALND,0.08,0.0,Panel,7200,925,1683,319,231,606,1452,0.09870000000000001,0
MTURK,6c418c234637a262f4b3cc8fbb2ab683,31MCUE39BKNXNBMJ0GDA8QBDCAZ3GB,0.04,0.0,Panel,7200,780,1379,247,73,533,1306,0.04766111111111111,0
MTURK,6c418c234637a262f4b3cc8fbb2ab683,3XUY87HIVPFY17QFH1GKHU4G8N1MMR,0.08,0.0,Panel,7200,778,1379,245,73,533,1306,0.09532222222222222,0
MTURK,6c418c234637a262f4b3cc8fbb2ab683,3VO4XFFP15N61JHK5OLCFLRVNZ27QN,0.06,0.0,Panel,7200,686,1316,216,64,470,1252,0.07096666666666666,0
MTURK,6c418c234637a262f4b3cc8fbb2ab683,3RQVKZ7ZRKKP90FZ3DVBJ3TS7TJ724,0.04,0.0,Panel,7200,604,45598,191,58,413,45540,0.2933222222222222,0
MTURK,6c418c234637a262f4b3cc8fbb2ab683,3L21G7IH47X1ZZT47ILXRX3KJM8Y19,0.06,0.0,Panel,7200,531,45418,179,53,352,45365,0.43848333333333334,0
MTURK,6c418c234637a262f4b3cc8fbb2ab683,3M0556243SLYDFJY7FR7ZJ97GCSFN6,0.08,0.0,Panel,7200,484,45238,179,51,305,45187,0.5826444444444444,0
MTURK,6c418c234637a262f4b3cc8fbb2ab683,3GMLHYZ0LEYH8WK296VH2Z8HUJ6UY5,0.04,0.0,Panel,7200,272,44848,93,32,179,44816,0.28915555555555555,0
MTURK,6c418c234637a262f4b3cc8fbb2ab683,3H781YYV6TJ42EOM90TDQ0UZTSDTEF,0.08,0.0,Panel,7200,246,44818,82,30,164,44788,0.5779777777777778,0
MTURK,6c418c234637a262f4b3cc8fbb2ab683,363A7XIFV4NGPTBZYQR6VZST5ZPAVD,0.04,0.0,Panel,7200,192,44668,66,85,126,44583,0.28815555555555555,0
MTURK,6c418c234637a262f4b3cc8fbb2ab683,3QXFBUZ4ZKHHM5Z2F09BVZ1DPNTGU6,0.04,0.0,Panel,7200,183,44578,66,174,117,44404,0.28765555555555555,0
MTURK,6c418c234637a262f4b3cc8fbb2ab683,3W0KKJIARRAOQUO82OTLXZBHZDAK8P,0.08,0.0,Panel,7200,177,44548,66,204,111,44344,0.5749777777777778,0
MTURK,6c418c234637a262f4b3cc8fbb2ab683,34R3P23QHS28E5JIU66UYNYBP40WH5,0.08,0.0,Panel,7200,40,29370,10,1498,30,27872,0.4063333333333334,1
MTURK,6c418c234637a262f4b3cc8fbb2ab683,36QZ6V15898YDIKTN2Y6DFJJVQ8SUA,0.07,0.0,Upside Services Inc,3600,40,2699,26,1989,14,710,0.12248055555555556,1
MTURK,6c418c234637a262f4b3cc8fbb2ab683,3511RHPADVF5S5LMMXBM3GJ1E7TRL5,0.06,0.0,Panel,7200,29,2117,29,2014,0,103,0.07764166666666666,1
MTURK,6c418c234637a262f4b3cc8fbb2ab683,3HEA4ZVWVDN2LTK3X3ICJQI80Z555I,0.06,0.0,Panel,7200,31,2499,31,2140,0,359,0.080825,1
MTURK,6c418c234637a262f4b3cc8fbb2ab683,37MQ8Z1JQEX8OKB0QMLBWGDPBUHY2P,0.08,0.0,Panel,7200,31,2641,31,2140,0,501,0.10934444444444445,1
MTURK,6c418c234637a262f4b3cc8fbb2ab683,3RQVKZ7ZRKKP90FZ3DVBJ3TS7V972Y,0.08,13.0,Panel,7200,32,2814,32,2128,0,686,0.11126666666666667,1
MTURK,6c418c234637a262f4b3cc8fbb2ab683,3T2HW4QDUVCMG0V067BV1C1DPXSC9U,0.35,10.0,Alan Ritter,3600,23,1843,23,1790,0,53,0.5291805555555555,1
MTURK,6c418c234637a262f4b3cc8fbb2ab683,33NOQL7T9O0JFPNU2PWVKEZU3OEZ8L,0.08,0.0,Panel,7200,32,3086,32,2087,0,999,0.11428888888888888,1
MTURK,6c418c234637a262f4b3cc8fbb2ab683,3T5ZXGO9DEPPLTNQOJDV65KUXU0QZN,0.08,0.0,Panel,7200,32,3235,32,2058,0,1177,0.11594444444444445,1
MTURK,6c418c234637a262f4b3cc8fbb2ab683,3J6BHNX0U9T9T1BC8QI4FW1COA1NKC,0.08,0.0,Panel,7200,32,3253,32,1960,0,1293,0.11614444444444444,1
MTURK,6c418c234637a262f4b3cc8fbb2ab683,389A2A304OJOP77HF7Z8G1SRB8EC0A,0.08,0.0,Panel,7200,32,3436,32,1960,0,1476,0.11817777777777778,1
MTURK,6c418c234637a262f4b3cc8fbb2ab683,3ZC62PVYDHBKPVON9FK23S0CMXQXXV,0.08,0.0,Panel,7200,32,3576,32,1934,0,1642,0.11973333333333333,1
MTURK,6c418c234637a262f4b3cc8fbb2ab683,362E9TQF2HRCDE42LJKXCWD2VURGIN,0.06,0.0,Panel,7200,33,3683,33,1925,0,1758,0.09069166666666667,1
MTURK,6c418c234637a262f4b3cc8fbb2ab683,3TX9T2ZCB92U5QJC0SC1YU2GLVFWZV,0.08,0.0,Panel,7200,33,3788,33,1925,0,1863,0.12208888888888889,1
MTURK,6c418c234637a262f4b3cc8fbb2ab683,33Q5P9PUSPNLRSD7J1C0M0VDTF1CZ6,0.08,0.0,Panel,7200,34,3814,34,1922,0,1892,0.12237777777777778,1
MTURK,6c418c234637a262f4b3cc8fbb2ab683,3KTCJ4SCVG215I4QOFXMX2GDAESM19,0.06,0.0,Panel,7200,36,4217,36,2026,0,2191,0.09514166666666667,1
MTURK,6c418c234637a262f4b3cc8fbb2ab683,3TKXBROM5TBM4GU3TP50995INM8IJT,0.08,0.0,Panel,7200,36,4405,36,1989,0,2416,0.12894444444444444,1
MTURK,6c418c234637a262f4b3cc8fbb2ab683,39I4RL8QGK3YSCW0AB9ESIW1KLG4H6,1.0,1.0,HBS Behavioral Research,3600,4,307,4,195,0,112,1.0852777777777778,1
MTURK,13327b278744b9997a995fbfcc83d9e,3W9XHF7WGLV68SQR2YVUGGPI6QVTK3,2.0,1.0,HCI Lab,7200,96,750,30,12,66,738,2.2083333333333335,1
MTURK,13327b278744b9997a995fbfcc83d9e,31KPKEKW4AE5F2FB173D5HM9T660BL,0.08,92.0,Panel,7200,146,779,55,18,91,761,0.08865555555555556,0
MTURK,13327b278744b9997a995fbfcc83d9e,3CVDZS288H1SVXYYVEC7M4K7B77FM1,0.08,92.0,Panel,7200,146,779,55,18,91,761,0.08865555555555556,0
MTURK,13327b278744b9997a995fbfcc83d9e,3E22YV8GG17A4S8SLINCBDNBI3WPN6,0.08,172.0,Panel,7200,163,809,65,20,98,789,0.0889888888888889,0
MTURK,13327b278744b9997a995fbfcc83d9e,3VCK0Q0PO5F7GB484X8MWCM3AV70NX,0.08,22.0,Panel,7200,214,959,80,28,134,931,0.09065555555555556,0
MTURK,13327b278744b9997a995fbfcc83d9e,3LN50BUKPVCKGS57957XYLJMD8MLPQ,0.08,49.0,Panel,7200,255,1050,107,45,148,1005,0.09166666666666667,0
MTURK,13327b278744b9997a995fbfcc83d9e,34YWR3PJ28BCS5IC63VVUED1C9UX0R,0.08,49.0,Panel,7200,256,1050,108,45,148,1005,0.09166666666666667,0
MTURK,13327b278744b9997a995fbfcc83d9e,30UZJB2POHDZ7EXZJKUJ4TKOMMW53C,0.08,106.0,Panel,7200,348,1139,162,55,186,1084,0.09265555555555556,0
MTURK,13327b278744b9997a995fbfcc83d9e,3XBYQ44Z6P5YJEADU0NJC61Z0IUWTI,0.08,106.0,Panel,7200,162,240,99,32,63,208,0.08266666666666667,0
MTURK,13327b278744b9997a995fbfcc83d9e,32LAQ1JNT9QLRAL8Z08IUIG2F3ATU9,0.08,124.0,Panel,7200,57,154,33,1,24,153,0.08171111111111111,0
MTURK,13327b278744b9997a995fbfcc83d9e,3E22YV8GG17A4S8SLINCBDNBI4WNP6,0.08,124.0,Panel,7200,51,149,30,5,21,144,0.08165555555555555,0
MTURK,13327b278744b9997a995fbfcc83d9e,35JDMRECC4A0X92GP0U6RHFA3KXEGR,0.08,64.0,Panel,7200,39,30,21,3,18,27,0.08033333333333334,0
MTURK,13327b278744b9997a995fbfcc83d9e,3W3RSPVVGSSX8XD3QR6R8R6LLQPUL8,0.08,0.0,Panel,7200,52,283,26,22,26,261,0.08314444444444445,1
MTURK,13327b278744b9997a995fbfcc83d9e,32CAVSKPCEQKIQ9ZXHO8OCX7NKL1UA,0.08,6.0,Panel,7200,73,389,44,51,29,338,0.08432222222222223,1
MTURK,13327b278744b9997a995fbfcc83d9e,3IZPORCT1FA3692WVCWOBOQUXACHRK,0.08,19.0,Panel,7200,76,210,49,49,27,161,0.08233333333333334,0
MTURK,13327b278744b9997a995fbfcc83d9e,3Z33IC0JC0N2KA1U6KD6Z4H9Z2JV91,0.08,0.0,Panel,7200,81,210,33,18,48,192,0.08233333333333334,0
MTURK,13327b278744b9997a995fbfcc83d9e,3O0M2G5VC633QXIFMOCJQEHWMIR948,0.08,1.0,Panel,7200,55,120,28,40,27,80,0.08133333333333334,0
MTURK,13327b278744b9997a995fbfcc83d9e,36U4VBVNQOE8BV8GVB3NU3FKRIFURZ,0.08,1.0,Panel,7200,53,90,28,16,25,74,0.081,0
MTURK,376b1526a10bc9d9ca8a71b51d951f6,3W9XHF7WGLV68SQR2YVUGGPI6QVTK3,2.0,1.0,HCI Lab,7200,44,595,12,168,32,427,2.165277777777778,1
MTURK,376b1526a10bc9d9ca8a71b51d951f6,374UMBUHO822FDHSVADFUSCAR7ZTCK,1.5,1.0,Columbia Marketing Lab,3600,1055,68307,20,920,1035,67387,29.961250000000003,0
MTURK,f0dacff155d4665310aa9c1b5b76c6c,3W9XHF7WGLV68SQR2YVUGGPI6QVTK3,2.0,1.0,HCI Lab,7200,43,480,5,32,38,448,2.1333333333333333,1
MTURK,f0dacff155d4665310aa9c1b5b76c6c,3EN4YVUOUBRXYAGMTPTXMJG8LBAXJW,0.16,1.0,Jonathan Winburn,1800,50,136,21,67,29,69,0.1720888888888889,1
MTURK,f0dacff155d4665310aa9c1b5b76c6c,37M4O367VIH7DKSZDMVQ3RMKTSQM56,1.0,0.0,Melanie B Brewer,600,81,239,35,139,46,100,1.3983333333333334,1
MTURK,f0dacff155d4665310aa9c1b5b76c6c,3VP28W7DVR8HMWLE5PBKNO6FDV0ZF3,0.7,0.0,Raffael Mogicato,1800,105,420,27,131,78,289,0.8633333333333333,1
MTURK,f0dacff155d4665310aa9c1b5b76c6c,341YLJU21KZE7H2WLZJPLF098LA2I8,5.0,1.0,Amplified Intelligence,2700,53,1140,14,19,39,1121,7.111111111111111,1
MTURK,f0dacff155d4665310aa9c1b5b76c6c,38EHZ67RIOEJYYZKYMBD26JH2L5GMW,0.5,1.0,Juriena de Vries,1800,43,138,27,101,16,37,0.5383333333333333,1
MTURK,f0dacff155d4665310aa9c1b5b76c6c,3JU8CV4BSO8I2C4ERFAVWCLJ6HWPOW,1.5,0.0,hri_lab,3600,2,3629,2,3629,0,0,3.0120833333333334,1
MTURK,d7a1761ca2820df428de327256d16,3XBYQ44Z7SK8X7GCOICTKDU1X40TWM,5.0,1.0,Joanne,1209600,787,34815,173,16616,614,18199,5.1439112103174605,1
MTURK,d7a1761ca2820df428de327256d16,3BAWBGQGYLAE2P0L32DQ0EOWGOP7V7,2.5,0.0,CCN Lab,1382400,1447,1761,345,19123,1102,-17362,2.5031846788194443,1
MTURK,d7a1761ca2820df428de327256d16,3CO05SML7W7O6ZIR5TCG0ANY8OKR03,0.52,0.0,Michael Otto,1814400,1447,1761,345,19123,1102,-17362,0.5205046957671958,1
MTURK,d7a1761ca2820df428de327256d16,3IVEC1GSMSIFS8QFNXG3K64ZV5Z1J1,0.3,1.0,DHRUV GREWAL,3600,35,1350,10,498,25,852,0.4125,1
MTURK,d7a1761ca2820df428de327256d16,3K3IX1W4S6RQUZ00O7L3S8FF4GFAPB,0.5,0.0,Julia Strizhakova,3600,19,1560,10,463,9,1097,0.7166666666666667,1
MTURK,d7a1761ca2820df428de327256d16,30EMX9PEVKJDKOGCIG8UI2TGYQ4KSP,1.0,0.0,Diana,7200,42,2999,12,433,30,2566,1.4165277777777778,1
MTURK,d7a1761ca2820df428de327256d16,329E6HTMSW1NY1FKI4KBSBCVH5VK3T,1.0,0.0,Dan Smilek,2400,2,59,2,59,0,0,1.0245833333333334,1
MTURK,d7a1761ca2820df428de327256d16,31HLTCK4BLKPRJMTCYBY8BY25VSVGI,0.25,0.0,Tianqi,1800,4,269,4,268,0,1,0.2873611111111111,1
MTURK,d7a1761ca2820df428de327256d16,371Q3BEXDHRHSISASJNMKUM92S0SZ2,3.0,0.0,Ron Walters,3600,16,1739,6,179,10,1560,4.449166666666667,1
MTURK,d7a1761ca2820df428de327256d16,3KVQ0UJWPXLAZSHN811C281D8GT5WN,1.0,0.0,SS Behavior Lab,3600,18,1679,6,59,12,1620,1.466388888888889,1
MTURK,d7a1761ca2820df428de327256d16,39WICJI5ATSR7XQFOG3KE9EUEQLZ3G,0.5,0.0,MSH University of Grenoble,1800,14,1435,4,827,10,608,0.8986111111111111,1
MTURK,d7a1761ca2820df428de327256d16,3BAKUKE49HDJQC5LAPB3LB329TQR1I,0.3,0.0,Consumer Lab,1800,14,1435,4,827,10,608,0.5391666666666667,1
MTURK,d7a1761ca2820df428de327256d16,3EGKVCRQFWSVL2JR9WBDZR4BW6NBY5,1.0,0.0,Social Psychology Experiment,14400,60,17912,12,826,48,17086,2.243888888888889,1
MTURK,d7a1761ca2820df428de327256d16,3OZ4VAIBF0UY8WITNTBU6RNBJBHVJB,3.0,0.0,Fireman Lab,36000,54,54802,25,9,29,54793,7.566833333333333,1
MTURK,d7a1761ca2820df428de327256d16,3AC6MFV6AO62NFRKPU9VM0MUG11ZH9,5.0,0.0,Devin Antonio,86400,61,54808,32,14,29,54794,8.17175925925926,1
MTURK,d7a1761ca2820df428de327256d16,35ZRNT9RUJVFCODMSQAC8K92N3W3OZ,0.5,1.0,GC,1200,108,7075,60,6789,48,286,3.447916666666667,1
MTURK,d7a1761ca2820df428de327256d16,3NSCTNUR2ZV6LNQZFX6A1946Q9PA5F,0.4,1.0,MF Kneer,3600,98,7064,50,6780,48,284,1.184888888888889,1
MTURK,d7a1761ca2820df428de327256d16,31JUPBOORPB91GH268URQWEU0H48LL,0.6,1.0,EWD Surveys,3600,98,7064,50,6780,48,284,1.7773333333333334,1
MTURK,d7a1761ca2820df428de327256d16,3TZDZ3Y0KWO24MRCL4VKUIVKT6U91C,2.0,0.0,Paul Rohde,360000,619,30850,141,9994,478,20856,2.171388888888889,1
MTURK,d7a1761ca2820df428de327256d16,3NBFJK3IOHJMM41QBXID44PX1S4OGI,1.5,0.0,Daniel Smith,7200,127,8515,25,64,102,8451,3.2739583333333337,1
MTURK,d7a1761ca2820df428de327256d16,3EPG8DX9LLE8JDRMQKOOZC00QT9P54,3.0,0.0,CoCoSci Lab at Princeton,3600,136,8535,26,45,110,8490,10.1125,1
MTURK,d7a1761ca2820df428de327256d16,3NBFJK3IOHIJQAODBSI6DW36HY7GOC,1.0,64.0,Emily Vraga,5400,75,19765,9,34,66,19731,4.660185185185185,1
MTURK,d7a1761ca2820df428de327256d16,3FTID4TN8LK6G5EXYDOW4L0IO10LYR,1.0,0.0,V Job,6000,89,81298,36,2314,53,78984,14.549666666666667,1
MTURK,d7a1761ca2820df428de327256d16,302OLP89D0ZNV01LNEH9ZEQVJZBAC0,1.0,0.0,Alexandria (University of Queensland),172800,81,81294,34,2314,47,78980,1.4704513888888888,1
MTURK,d7a1761ca2820df428de327256d16,33EEIIWHLBGP2AJK51MHNQ5QEVRQVJ,2.0,0.0,Laura,172800,70,81294,23,2314,47,78980,2.9409027777777776,1
MTURK,d7a1761ca2820df428de327256d16,3TRB893CSJ9COH04IE433P732497GS,0.6,0.0,Joe Hanna,3600,3,1920,3,1920,0,0,0.9199999999999999,1
MTURK,d7a1761ca2820df428de327256d16,3S8A4GJRD43W9IQMSSHYTITPYPX6V5,3.0,0.0,Ben Green,7200,53,79104,26,181,27,78923,35.96,1
MTURK,d7a1761ca2820df428de327256d16,37S0QRNUFBG29K8XXXPF9YCS8RO882,0.7,0.0,jaimie krems,1800,68,73961,28,19,40,73942,29.46261111111111,1
MTURK,d7a1761ca2820df428de327256d16,3N5YJ55YXG3JYMN9E2UJ1TFWJQHNAM,0.5,0.0,Ashley,7200,67,73961,27,19,40,73942,5.636180555555556,1
MTURK,d7a1761ca2820df428de327256d16,39KV3A5D186JQRD3F1WGZY908587SZ,0.5,0.0,Researcher,7200,67,73961,27,19,40,73942,5.636180555555556,1
MTURK,d7a1761ca2820df428de327256d16,3QGTX7BCHPLOBVCHGJGB8K2IS8D5ZN,0.8,0.0,chris.lab111,10800,67,73961,27,19,40,73942,6.2785925925925925,1
MTURK,d7a1761ca2820df428de327256d16,3OQQD2WO8H5N3WOZD5C3FFAMYQVI3H,1.0,0.0,nathan scharf,108000,62,73961,22,19,40,73942,1.684824074074074,1
MTURK,d7a1761ca2820df428de327256d16,3XDSWAMB22ELXWN76UKPHPP5BK0CQA,1.0,0.0,Tyler Psychology Lab,172800,593,58451,152,193,441,58258,1.3382581018518518,1
MTURK,d7a1761ca2820df428de327256d16,3UQ1LLR26AQN9SRIB6753YLFYABLA3,1.0,0.0,Ethan Pancer,7200,277,2159,60,116,217,2043,1.2998611111111111,1
MTURK,d7a1761ca2820df428de327256d16,3QGTX7BCHPYWSWY4Y71I06ARRTM5ZS,1.0,0.0,bonnie hao,7200,358,69060,105,363,253,68697,10.591666666666667,1
MTURK,d7a1761ca2820df428de327256d16,3L55D8AUFA2FVGQ18RYU8GVP10YCY0,8.0,0.0,Hilla Shinitzky,5400,84,10278,48,9131,36,1147,23.226666666666667,1
MTURK,d7a1761ca2820df428de327256d16,3L4YG5VW9NOPNBJ9GWQF4SGRYHKDDB,1.0,0.0,Psychological Experiments Brussels,7200,65,10260,31,9130,34,1130,2.425,1
MTURK,d7a1761ca2820df428de327256d16,3OZ4VAIBEXQKUXJIF1S56MZSG7PVJJ,2.0,0.0,Amodio Lab,14400,133,13149,70,9760,63,3389,3.82625,1
MTURK,d7a1761ca2820df428de327256d16,3AXFSPQOZTBSWWYVX39ZTAXP9NRFJW,2.5,0.0,Egnerlab,3600,92,17768,51,16809,41,959,14.838888888888889,1
MTURK,d7a1761ca2820df428de327256d16,37VUR2VJ7EQ8QM2RCRNP71FPSP3C17,1.2,0.0,Michal Hadar,7200,82,17751,43,16822,39,929,4.1585,1
MTURK,2cd3cfa492db635891e3ea3b402982,3W9XHF7WGLV68SQR2YVUGGPI6QVTK3,2.0,1.0,HCI Lab,7200,93,879,6,5,87,874,2.2441666666666666,1
MTURK,2cd3cfa492db635891e3ea3b402982,3VP28W7DUNKMS2WM9FCPKD25F93ZF4,1.0,1.0,Christian Siebert,7200,103,2790,48,87,55,2703,1.3875,1
MTURK,2cd3cfa492db635891e3ea3b402982,3UQ1LLR26BS9JK96N5A1SSN6VOVLAE,0.75,1.0,Vincenzo Iacoviello,1500,103,826,48,135,55,691,1.163,1
MTURK,2cd3cfa492db635891e3ea3b402982,3Z33IC0JC0FFVYOJB0PP9E697VKV90,0.75,1.0,Spencer Kimball,1200,177,300,20,24,157,276,0.9375,1
MTURK,2cd3cfa492db635891e3ea3b402982,32L724R86OVTJ9PCHS5JCO3FY5ZIPM,0.55,481.0,Shuxiang Wu,3600,36,72,21,36,15,36,0.561,0
MTURK,2cd3cfa492db635891e3ea3b402982,3PR3LXCWSF5DJ7VFSCHNMUUQEX5X94,1.0,11.0,dan,3600,70,2666,16,20,54,2646,1.7405555555555554,1
MTURK,2cd3cfa492db635891e3ea3b402982,3C8QQOM6JP12CY9N9RVGK1EUIBBLIE,0.75,1.0,SEUNGA JIN,3600,197,2508,54,111,143,2397,1.2725,1
MTURK,2cd3cfa492db635891e3ea3b402982,3NC6WP7WJH8U2MFXMPPMQ3AC32SWWH,0.7,16.0,TradeVisibility,86400,76,528,35,55,41,473,0.7042777777777778,1
MTURK,2cd3cfa492db635891e3ea3b402982,3D17ECOUOEVNSDI41B2XG9712SR31M,0.67,25.0,Research Surveys,1080,47,79,23,26,24,53,0.7190092592592593,0
MTURK,2cd3cfa492db635891e3ea3b402982,3T8DUCXY0N6ACGQUMHC4LZA0QUCT9Z,0.5,43.0,tobias schlager,3600,76,788,14,5,62,783,0.6094444444444445,1
MTURK,2cd3cfa492db635891e3ea3b402982,3GV1I4SEOB2XVA7TWJ4GZ5VXNZIL6S,0.7,1.0,Gibbon's Research,18000,60,108,24,32,36,76,0.7041999999999999,0
MTURK,2cd3cfa492db635891e3ea3b402982,37S0QRNUFBG4Y4JRN2PXBL05BVV886,0.5,1.0,John Wixted,900,19,31,14,8,5,23,0.5172222222222222,0
MTURK,2cd3cfa492db635891e3ea3b402982,3XABXM4AJ2C6X18RNAY661IQQ2K8QQ,0.5,1.0,LBC Mechanical Turk,1800,21,962,19,957,2,5,0.7672222222222222,1
MTURK,2cd3cfa492db635891e3ea3b402982,3N3WJQXELTZ6VPCH2YQ9ZB316Q3L2N,0.45,1.0,Alexander Park,1800,82,510,11,13,71,497,0.5775,1
MTURK,2cd3cfa492db635891e3ea3b402982,38B7Q9C28HALZMK300CPVZWJKK869A,0.9,1.0,Polly Hodgkin,5400,134,2821,49,211,85,2610,1.3701666666666668,1
MTURK,2cd3cfa492db635891e3ea3b402982,3B6F54KMR2N1FT7D8L0H49979NYS1W,1.0,1.0,Albert Lee,2700,40,45,23,26,17,19,1.0166666666666666,0
MTURK,2cd3cfa492db635891e3ea3b402982,36D1BWBEIR1JRI06CCVP976FXI72MT,5.0,1.0,Joseph MacDonald,7200,93,1739,9,1023,84,716,6.207638888888889,1
MTURK,2cd3cfa492db635891e3ea3b402982,3IZPORCT1HXDVRWADULBRZFHIESRH7,2.75,132.0,Noah Turk,1800,32,834,13,70,19,764,4.024166666666667,0
MTURK,2cd3cfa492db635891e3ea3b402982,32PT7WK7DNWTEUKOQQ8FC793Q3BD3S,0.7,1.0,Alessandro Nai,3600,124,1250,25,29,99,1221,0.9430555555555555,1
MTURK,2cd3cfa492db635891e3ea3b402982,3J06WJ78IQS02C8J474LR3S6NDWVVC,0.65,58.0,CRF Research,1800,57,552,12,17,45,535,0.8493333333333334,1
MTURK,2cd3cfa492db635891e3ea3b402982,3P888QFVX2TKC5BNQDKM1DTRK72QOE,0.36,45.0,Stanford GSB Behavioral Lab,1200,57,300,14,17,43,283,0.44999999999999996,1
MTURK,2cd3cfa492db635891e3ea3b402982,34D9ZRXCYRVZJS7LUA5X9AS9OVPSA7,0.5,46.0,Remi Trudel,1200,30,33,21,23,9,10,0.51375,0
MTURK,2cd3cfa492db635891e3ea3b402982,3HA5ODM5KA1MSY2EDCC5NP6KMERSV5,0.5,1.0,Cedric Lehmann,1800,177,879,18,84,159,795,0.7441666666666666,1
MTURK,2cd3cfa492db635891e3ea3b402982,39HYCOOPKOSE4LZ4NKLHGWR7CGQMDO,2.5,0.0,Ivar Vermeulen,7200,115,2256,46,80,69,2176,3.283333333333333,1
MTURK,2cd3cfa492db635891e3ea3b402982,31KPKEKW4A5NY2HVVPRY1TJE073B0X,0.82,0.0,Emily Powell,2700,82,870,14,15,68,855,1.0842222222222222,1
MTURK,2cd3cfa492db635891e3ea3b402982,3OLZC0DJ8JMR9A5SKWW5RLHG7OTVIU,0.5,1.0,Tuck Behavioral Research Lab,10800,70,600,14,21,56,579,0.5277777777777778,1
MTURK,2cd3cfa492db635891e3ea3b402982,3RWO3EJELHDQHNQZ6J88E64UTNZ1PU,1.5,1.0,Andreas Fügener,9000,223,6169,36,44,187,6125,2.5281666666666665,1
MTURK,2cd3cfa492db635891e3ea3b402982,3X52SWXE10JWJ5E2GMK1SZ16Z5ICWN,1.0,1.0,zhibo xu,1200,150,1119,34,109,116,1010,1.9325,1
MTURK,2cd3cfa492db635891e3ea3b402982,3KI0JD2ZU1IZ6CPTDB6SPRH6BI7672,0.75,1.0,Acme Data Collection,3600,199,2565,62,1313,137,1252,1.284375,0
MTURK,2cd3cfa492db635891e3ea3b402982,3MYASTQBHBEN1WH9V6EHVABAPRQQDI,1.0,126.0,AQUX,3600,33,1398,16,735,17,663,1.3883333333333332,1
MTURK,2cd3cfa492db635891e3ea3b402982,3CRWSLD91K94NWW2BN93OKVVP69OMM,0.9,1.0,Sujin Lee,10800,45,1287,22,59,23,1228,1.00725,1
MTURK,2cd3cfa492db635891e3ea3b402982,34ZTTGSNJXYZLEXH7JK7LPRZZAAQHM,1.0,1.0,SoundingBox (Change Sciences Group),7200,80,3241,20,245,60,2996,1.4501388888888889,0
MTURK,2cd3cfa492db635891e3ea3b402982,3CO05SML7V5F4QIOGIZTK2R73Q20R9,0.75,27.0,Research Surveys,1500,59,137,28,71,31,66,0.8185,0
MTURK,2cd3cfa492db635891e3ea3b402982,3M4KL7H8KVNLX7DMGPNOJ7YTHWQ16S,0.55,1.0,The Wharton School,2700,58,810,14,2,44,808,0.7150000000000001,1
MTURK,2cd3cfa492db635891e3ea3b402982,3AXFSPQOYQZOSY96VOM2WYDQOZ7JF9,0.6,1.0,ConsumerDecision,1800,33,34,17,9,16,25,0.6113333333333333,0
MTURK,2cd3cfa492db635891e3ea3b402982,3MDKGGG61RWIW33NY943BFUUGHKT6Q,0.5,1.0,Alexander Park,1800,51,467,14,49,37,418,0.6297222222222222,1
MTURK,2cd3cfa492db635891e3ea3b402982,3YOAVL4CA26BUPHR3QIRMFZL7JK4ZE,0.6,105.0,L Niemi,3600,61,1099,10,37,51,1062,0.7831666666666667,1
MTURK,2cd3cfa492db635891e3ea3b402982,3VJ4PFXFJ53PE3YWELFFPW7C75YAU9,0.5,0.0,Dialogue Research,1800,64,42,19,18,45,24,0.5116666666666667,0
MTURK,2cd3cfa492db635891e3ea3b402982,388CL5C1RL7GS5WQ2J8S3KSMMTCLH9,0.5,1.0,MOONSU KOO,1800,26,31,17,12,9,19,0.5086111111111111,0
MTURK,2cd3cfa492db635891e3ea3b402982,3L21G7IH47WRX8MTN6NHH5PCH22Y19,0.5,1.0,Lars Drewes,3600,78,968,28,561,50,407,0.6344444444444445,0
MTURK,2cd3cfa492db635891e3ea3b402982,35U0MRQMUJ7JSDN0N6SFPCIQI8NVOB,1.0,1.0,SS Behavior Lab,3600,31,33,13,8,18,25,1.0091666666666668,0
MTURK,2cd3cfa492db635891e3ea3b402982,3JGHED38EDH5WTQYWIJFAXY4HUU7YW,0.5,1.0,Xiaodong Nie,3000,83,1400,36,60,47,1340,0.7333333333333334,1
MTURK,2cd3cfa492db635891e3ea3b402982,3C8QQOM6JO04J0EOJBG3B143YBHLIR,1.0,0.0,nathan scharf,108000,111,2416,34,102,77,2314,1.0223703703703704,1
MTURK,2cd3cfa492db635891e3ea3b402982,3WRBLBQ2HVWRLYQJ1UELV177JZX0GL,5.0,0.0,Devin Antonio,86400,355,9349,72,2281,283,7068,5.541030092592592,1
MTURK,2cd3cfa492db635891e3ea3b402982,3PUOXASB573SHBAVXEFT0L6D0N3Z90,2.0,0.0,Rachel Burgess,5400,142,1199,39,72,103,1127,2.444074074074074,1
MTURK,2cd3cfa492db635891e3ea3b402982,39AYGO6AFFKPZKJCRENGSQD6CK4N6M,0.5,15.0,tobias schlager,3600,143,1152,16,49,127,1103,0.66,1
MTURK,2cd3cfa492db635891e3ea3b402982,3421H3BM99G88KCA7POJYBJJLSTJ92,0.6,1.0,Ryan Buell,3600,64,112,18,23,46,89,0.6186666666666667,0
MTURK,2cd3cfa492db635891e3ea3b402982,3QD8LUVX4XYG38AB2VBNWBKUMKBX5H,5.0,17.0,Michael R Parke,5400,400,5231,64,269,336,4962,9.843518518518518,1
MTURK,2cd3cfa492db635891e3ea3b402982,3D1UCPY6GG2HA92Y13424BXQB5P83S,1.0,1.0,Chenghui Zhang,7200,83,1967,33,197,50,1770,1.2731944444444445,1
MTURK,2cd3cfa492db635891e3ea3b402982,3ZICQFRS45S2V5OREZT6UN26I0ZZZX,1.2,1.0,Communication Neuroscience Lab,7200,69,1296,27,99,42,1197,1.416,1
MTURK,2cd3cfa492db635891e3ea3b402982,3HJ1EVZS2OJATTPLVH45IV4MB5SR3M,0.5,1.0,The Wharton School,2700,58,484,23,15,35,469,0.5896296296296296,1
MTURK,2cd3cfa492db635891e3ea3b402982,3DWGDA5POF4PY6HW30HMBIU6OAE1V9,0.5,1.0,Shan Li,3600,245,1762,62,32,183,1730,0.7447222222222223,0
MTURK,2cd3cfa492db635891e3ea3b402982,3W3RSPVVGSZ42L7IDP38IZCXJ72LUL,0.4,1.0,MF Kneer,3600,291,2040,61,63,230,1977,0.6266666666666667,1
MTURK,2cd3cfa492db635891e3ea3b402982,36D1BWBEIQET80CHA2CQIK0Q2CUM2F,0.4,1.0,UPenn Researcher,3600,294,2287,54,83,240,2204,0.6541111111111111,1
MTURK,2cd3cfa492db635891e3ea3b402982,3NSM4HLQNS94LKKNTN5TB3CBHD9QQF,0.4,71.0,FW,3600,159,990,38,115,121,875,0.51,1
MTURK,2cd3cfa492db635891e3ea3b402982,3DZKABX2ZICFYLCXASXP7VJ3IBJVCL,0.41,1.0,Imanol Arrieta Ibarra,1000,118,977,42,529,76,448,0.81057,0
MTURK,2cd3cfa492db635891e3ea3b402982,39TX062QY4DFZO3R8R5M7OWAMST3XC,0.4,10.0,Hyoseok Kim,1800,188,1192,44,275,144,917,0.6648888888888889,0
MTURK,2cd3cfa492db635891e3ea3b402982,356TQKY9XF7E99AAKBGCRO91QG178K,0.35,1.0,The Choice Lab,3600,60,938,35,221,25,717,0.44119444444444444,1
MTURK,2cd3cfa492db635891e3ea3b402982,3L2OEKSTW9B6SBQ3S9DWGQ3PHQJY83,1.5,0.0,ETH DeSciL,2700,109,1452,27,42,82,1410,2.3066666666666666,1
MTURK,2cd3cfa492db635891e3ea3b402982,3URJ6VVYUPNPNBQLM2KVQ1BBKU84OJ,0.3,27.0,Research Group,1800,53,1215,10,44,43,1171,0.5025,1
MTURK,2cd3cfa492db635891e3ea3b402982,3ICOHX7ENCG55F1MJNMW6MOB5BKE05,3.75,0.0,Research Methods,7200,233,4556,50,220,183,4336,6.122916666666667,1
MTURK,2cd3cfa492db635891e3ea3b402982,3UUIU9GZC5KD2P604IPXVBADWZIT5X,0.75,75.0,Thought Lab,5400,41,831,11,25,30,806,0.8654166666666667,1
MTURK,2cd3cfa492db635891e3ea3b402982,3ZQX1VYFUHSFQ562UBIUEZOY3WQO8C,0.3,1.0,Conversionxl LLC,14400,84,338,33,43,51,295,0.30704166666666666,1
MTURK,2cd3cfa492db635891e3ea3b402982,3SV8KD29L4QAJMAJZ5T468YYOZAKZK,0.3,1.0,Kickstand Communications,25200,114,1957,28,33,86,1924,0.32329761904761906,1
MTURK,2cd3cfa492db635891e3ea3b402982,3RWB1RTQDJUHRJ3L7DZ1ND1J48T8PX,0.4,0.0,Hameed Schaker,3600,49,1800,21,104,28,1696,0.6000000000000001,1
MTURK,2cd3cfa492db635891e3ea3b402982,3LG268AV38P8DYD8JX78JDOVID8RE1,1.0,17.0,Saku Sugawara,1800,49,864,23,158,26,706,1.48,0
MTURK,2cd3cfa492db635891e3ea3b402982,3S1L4CQSG1T8LPO6Z1W060XMWZPFAE,0.75,1.0,Survey Launcher,1800,128,621,25,64,103,557,1.00875,1
MTURK,2cd3cfa492db635891e3ea3b402982,3HUR21WDDUPA9EMH24FMG2N3UCOXY3,0.5,0.0,Derek J Koehler,3600,145,1505,58,158,87,1347,0.7090277777777778,1
MTURK,2cd3cfa492db635891e3ea3b402982,3SBNLSTU6UME5NDE8SPHLXSY3EEZDL,0.4,1.0,Center for Transportation Safety,1800,46,826,20,28,26,798,0.5835555555555556,1
MTURK,2cd3cfa492db635891e3ea3b402982,36KM3FWE3RIAN0NJE6VQ3F6RWZY079,0.4,1.0,Avishek Lahiri,7200,122,794,46,95,76,699,0.4441111111111111,0
MTURK,2cd3cfa492db635891e3ea3b402982,356TQKY9XGXT76AI05H05C719CE787,0.6,89.0,Pinterest,1200,27,32,11,6,16,26,0.616,0
MTURK,2cd3cfa492db635891e3ea3b402982,3D06DR5225KPXQTA8BD9P1RY6VMMA9,0.5,1.0,Joseph Hayes,3600,149,1336,46,56,103,1280,0.6855555555555556,1
MTURK,2cd3cfa492db635891e3ea3b402982,3YLTXLH3EJSK0UNPRIXFAPT4TS3PHC,0.5,1.0,Bethany Torimino,3600,280,2658,81,294,199,2364,0.8691666666666666,1
MTURK,2cd3cfa492db635891e3ea3b402982,3I6NF2WGIGHMXNDAWYVRXDEQDY9G53,1.5,48.0,Tamara Berg,3600,34,198,26,190,8,8,1.5825,0
MTURK,2cd3cfa492db635891e3ea3b402982,3KLL7H3EGDWXN51WB9P7CC8V1RHVHI,0.99,0.0,TRECvid Research,5400,174,4176,49,1747,125,2429,1.7556,1
MTURK,2cd3cfa492db635891e3ea3b402982,3V8JSVE8Z2FL4OW9MA4I5G4BBMDYE1,0.75,1.0,Joseph,2700,303,2067,43,703,260,1364,1.3241666666666667,1
MTURK,2cd3cfa492db635891e3ea3b402982,3EHIMLB7F7KJK1RNE2KCUX0IUON8HW,1.5,47.0,Tamara Berg,3600,235,1200,70,79,165,1121,2.0,0
MTURK,2cd3cfa492db635891e3ea3b402982,3VDI8GSXAFTNUP1JKWYYZH4DL4TG8Y,0.3,32.0,syu,1800,108,692,28,41,80,651,0.41533333333333333,1
MTURK,2cd3cfa492db635891e3ea3b402982,3OEWW2KGQJQSQB5SZOXHDLD4WPPDOO,0.3,18.0,sustyyl,3600,248,1188,87,121,161,1067,0.39899999999999997,0
MTURK,2cd3cfa492db635891e3ea3b402982,3VDI8GSXAF8SH3S3UX9TMKQ1UC1G8Y,0.3,18.0,sustyyl,3600,32,32,23,19,9,13,0.30266666666666664,0
MTURK,2cd3cfa492db635891e3ea3b402982,3VEI3XUCZSD2STR9G0DW14W6KS4RPN,0.35,1.0,Mian Jia,1800,51,1050,26,41,25,1009,0.5541666666666667,1
MTURK,2cd3cfa492db635891e3ea3b402982,3FJ2RVH25Z639P423UZQQ66ZPQW92Q,0.25,27.0,Rammy Salem,3600,39,170,11,59,28,111,0.26180555555555557,1
MTURK,2cd3cfa492db635891e3ea3b402982,38LRF35D5LX6CVGNYAFE309DWWB3U1,1.5,0.0,Psych,5400,63,1301,11,58,52,1243,1.861388888888889,1
MTURK,2cd3cfa492db635891e3ea3b402982,302U8RURJZ13UFUL6UB7RTOUL3IVNY,0.45,1.0,Wesley Buckwalter,7200,76,1309,37,86,39,1223,0.5318125,1
MTURK,2cd3cfa492db635891e3ea3b402982,3UEBBGULPGPQI928WWTMQMX7J0PUFC,0.3,1.0,Ryan Barry,900,47,916,11,89,36,827,0.6053333333333333,1
MTURK,2cd3cfa492db635891e3ea3b402982,3CZH926SIEHJ1I314FEK648QTB3E4J,0.33,84.0,Noah Turk,1800,28,1826,8,92,20,1734,0.6647666666666667,1
MTURK,2cd3cfa492db635891e3ea3b402982,3PEG1BH7AEY0NUS893Y4V92O2YVBK0,0.5,28.0,Interaction Design Lab,1800,32,98,15,23,17,75,0.5272222222222223,0
MTURK,2cd3cfa492db635891e3ea3b402982,3V0TR1NRVAFQOED9R9IW240C4J14A1,0.25,1.0,Esther Matthews,1200,50,496,29,49,21,447,0.35333333333333333,1
MTURK,2cd3cfa492db635891e3ea3b402982,37VUR2VJ6A1M80NEJTV0VV00PO6C1S,0.6,1.0,HLResearchLab,1800,120,893,46,56,74,837,0.8976666666666666,1
MTURK,2cd3cfa492db635891e3ea3b402982,3PA41K45VNZKHTQ2IP3AVYGDAZ87PJ,0.32,1.0,MOState,3600,44,377,25,80,19,297,0.3535111111111111,0
MTURK,2cd3cfa492db635891e3ea3b402982,3JUDR1D0EARJZ0UA2ZTFN83E0Z5Q22,0.3,338.0,Taeyeong Kim,1800,104,534,34,85,70,449,0.389,1
MTURK,2cd3cfa492db635891e3ea3b402982,3M7OI89LV0GOW2R5K9YKPV03DQJC6N,0.28,1.0,University of North Carolina at Chapel Hill,1800,25,53,13,30,12,23,0.28824444444444447,0
MTURK,2cd3cfa492db635891e3ea3b402982,3J6BHNX0UBKEML9LB31ZFPZXDQNKNQ,0.28,1.0,University of North Carolina at Chapel Hill,1800,66,180,17,17,49,163,0.30800000000000005,0
MTURK,2cd3cfa492db635891e3ea3b402982,3Z33IC0JC1DIAGNSFXTJB73MP1TV96,0.5,1.0,eplab,1800,105,780,33,85,72,695,0.7166666666666667,1
MTURK,2cd3cfa492db635891e3ea3b402982,3EAWOID6MVHLEA4HTTGTYUXHN1F0V3,0.5,998.0,IC3 AI team,3600,219,2251,163,2023,56,228,0.8126388888888889,1
MTURK,2cd3cfa492db635891e3ea3b402982,3R15W654VCSCLPQHGNM69JLR4LRQL4,0.3,0.0,Daniel Simons,1800,57,393,33,736,24,-343,0.3655,1
MTURK,2cd3cfa492db635891e3ea3b402982,38O9DZ0A624MPWU25WELTS7EB9O262,1.0,2.0,UserBob,3600,236,1693,18,64,218,1629,1.4702777777777778,1
MTURK,2cd3cfa492db635891e3ea3b402982,3S8A4GJRE6H0DV33MEQIVTTLUWOV6M,0.5,3.0,Yaqin,5400,63,625,18,23,45,602,0.5578703703703703,0
MTURK,2cd3cfa492db635891e3ea3b402982,336OE47KJ5P7YBAWC6J41RLNX9DWVB,0.25,1.0,jml250525,3600,541,3116,60,52,481,3064,0.46638888888888885,1
MTURK,2cd3cfa492db635891e3ea3b402982,3VDI8GSXAF48R6HBS39DUV2BOMT8GD,0.25,0.0,Beth Amos,3600,249,1037,62,59,187,978,0.3220138888888889,0
MTURK,2cd3cfa492db635891e3ea3b402982,3T5ZXGO9EIRI6NFNE2XR7V6285TQZS,0.25,56.0,Petra,900,65,912,28,529,37,383,0.5033333333333334,1
MTURK,2cd3cfa492db635891e3ea3b402982,301KG0KX9EY0Y0J472N9JTXLP8NH23,0.55,360.0,Multimodal Data,1800,121,1434,44,517,77,917,0.9881666666666669,1
MTURK,2cd3cfa492db635891e3ea3b402982,3M67TQBQQHO5XKRLGHLNQUK83E6A9T,0.3,16.0,tobias schlager,3600,81,705,10,47,71,658,0.35875,1
MTURK,2cd3cfa492db635891e3ea3b402982,3SZYX62S5GCS2R0B10CQY0BH7RN758,0.75,1.0,Ahmet Ozturk,7200,106,1342,56,463,50,879,0.8897916666666666,1
MTURK,2cd3cfa492db635891e3ea3b402982,3MVY4USGC9X7C2Y1Q83SF53Y2BBSII,1.2,17.0,Inske Groenen,5400,101,1718,58,1197,43,521,1.5817777777777777,0
MTURK,2cd3cfa492db635891e3ea3b402982,3GONHBMNHVW4ZAE8IV7ZIR32NLFZMT,0.55,13.0,Gabriela Tonietto,1800,81,513,17,14,64,499,0.7067500000000001,1
MTURK,2cd3cfa492db635891e3ea3b402982,3P6ENY9P7AY8AA7J6TPGF6VG8T7HI2,0.4,24.0,CDR Lab_OU,3600,60,439,25,81,35,358,0.44877777777777783,1
MTURK,2cd3cfa492db635891e3ea3b402982,3K2CEDRACB1OTD7SDUGAJJ6APX4MTU,0.75,1.0,Acme Data Collection,3600,34,279,13,55,21,224,0.808125,0
MTURK,2cd3cfa492db635891e3ea3b402982,3R4QIDVOJQO4I104P7VHWSFVZRSEE0,0.4,1.0,Anat Maril,600,22,75,11,30,11,45,0.45,0
MTURK,2cd3cfa492db635891e3ea3b402982,3B9XR6P1WEWYO2R6FEBVOXLXEYOJBA,0.5,1.0,CBStudies,1800,143,875,56,43,87,832,0.7430555555555556,1
MTURK,2cd3cfa492db635891e3ea3b402982,3AQN9REUTGJCH0IX4Q8UA5SBOYYYD7,0.5,1.0,Claire Growney,3600,137,286,41,50,96,236,0.5397222222222222,0
MTURK,2cd3cfa492db635891e3ea3b402982,34ZTTGSNJXPVFDMJ0E0YTWDNB3XQHC,0.5,1.0,Yunhui Huang,3600,105,248,19,11,86,237,0.5344444444444445,0
MTURK,2cd3cfa492db635891e3ea3b402982,3HFWPF5AK9KZRMUL34V5QHNUAK1S3D,0.25,1.0,HNKYDUYEN thanhtung,1200,206,658,73,57,133,601,0.38708333333333333,1
MTURK,2cd3cfa492db635891e3ea3b402982,3OLZC0DJ9MR5AEN31JPLQZUSUHIIV4,0.3,11.0,Stefan Uddenberg,900,72,279,19,26,53,253,0.393,1
MTURK,2cd3cfa492db635891e3ea3b402982,3MDKGGG61QW2GAK9GIW0X0C90YB6TR,0.3,11.0,Yonat,1800,226,983,73,58,153,925,0.4638333333333333,1
MTURK,2cd3cfa492db635891e3ea3b402982,3BCRDCM0OCTJALAXMIOH0W8MKUFK67,0.3,1.0,John Kim,1200,138,1156,53,198,85,958,0.589,1
MTURK,2cd3cfa492db635891e3ea3b402982,3ACRLU860NER3OR1A7FL1W17CJMBE2,0.4,1.0,Benjamin Bergen,7200,176,1520,57,181,119,1339,0.48444444444444446,1
MTURK,2cd3cfa492db635891e3ea3b402982,3RKHNXPHGWX8M0CE8YHDJDE6DGWKUS,0.6,1.0,ConsumerDecision,2400,18,33,11,2,7,31,0.60825,0
MTURK,2cd3cfa492db635891e3ea3b402982,3RTFSSG7T86V0K65U24JLHMHQ4CLWJ,1.0,1.0,Brian C. Rathbun,3600,297,1665,112,157,185,1508,1.4625,0
MTURK,2cd3cfa492db635891e3ea3b402982,33KGGVH25Y4AJSIUNUYJSBTQTCIX13,0.5,1.0,Behave4,600,88,210,41,46,47,164,0.675,1
MTURK,2cd3cfa492db635891e3ea3b402982,3JVP4ZJHDP3DVHSC11AYTJO5X220IA,0.5,1.0,SConti,3600,81,927,32,300,49,627,0.62875,1
MTURK,2cd3cfa492db635891e3ea3b402982,306W7JMRZ245U242E5FSLGOY42R8BC,0.7,1.0,PP Group,14400,114,1165,41,90,73,1075,0.7566319444444444,1
MTURK,2cd3cfa492db635891e3ea3b402982,302U8RURJY0XGBWTNTGHYUZWIIMNVU,0.5,0.0,Xiaojing Yang,2700,102,1064,37,83,65,981,0.697037037037037,1
MTURK,2cd3cfa492db635891e3ea3b402982,3L60IFZKF4AWQM855BS8GUZHQIPHHQ,5.0,1.0,Research Team,7200,259,2131,64,64,195,2067,6.479861111111111,1
MTURK,2cd3cfa492db635891e3ea3b402982,31HLTCK4BMZC2QNF3XTXQ9VHKZNVGZ,0.35,1.0,Brian Haas,3600,184,1492,58,239,126,1253,0.4950555555555555,1
MTURK,2cd3cfa492db635891e3ea3b402982,35A1YQPVFE3HLWLC934OEK282GGI5N,0.26,1.0,Tate Handy,3600,10,3671,10,3668,0,3,0.5251277777777777,1
MTURK,2cd3cfa492db635891e3ea3b402982,3ZURAPD2899U3N08Q34UU4A1FTA1FP,0.25,0.0,Arnold Yeung,7200,309,4372,100,525,209,3847,0.4018055555555555,1
MTURK,2cd3cfa492db635891e3ea3b402982,3QE4DGPGBR8EX6615APUMXAGTNL4G6,0.25,19.0,M Kwon,1800,79,540,24,35,55,505,0.325,1
MTURK,2cd3cfa492db635891e3ea3b402982,335VBRURDJR3KJ71P7GY1A4GMUE9EX,0.3,2.0,Reinald Kim Amplayo,480,43,426,33,400,10,26,0.5662499999999999,1
MTURK,2cd3cfa492db635891e3ea3b402982,3PGQRAZX02KYUVN12C7RXZKN1Z8YS6,0.5,1.0,Brandon Reich,1800,105,695,39,72,66,623,0.6930555555555555,1
MTURK,2cd3cfa492db635891e3ea3b402982,360ZO6N6J146AFTJ90N8BCQS1B59MQ,1.2,1.0,CBUA Research Group,3600,124,1055,18,42,106,1013,1.5516666666666665,0
MTURK,2cd3cfa492db635891e3ea3b402982,3W5PY7V3UP7YQN36ZCGF6G9V1F3JYA,0.9,1.0,Laura Kray,1800,107,1006,43,46,64,960,1.403,1
MTURK,2cd3cfa492db635891e3ea3b402982,356ZPKYPVK9FPBAF7SVLBYPKJIJYPF,0.3,1.0,Shahyaan Adil,3600,60,1140,25,264,35,876,0.395,0
MTURK,2cd3cfa492db635891e3ea3b402982,3G4VVJO6PZG8YUXZ6D08TSH0WXTKP5,0.3,18.0,NerdLab Lab Group,2700,59,416,20,62,39,354,0.3462222222222222,1
MTURK,2cd3cfa492db635891e3ea3b402982,3IV1AEQ4DSHYH4YP89ZBEKXUIOOJ8E,0.3,21.0,Matthew,1800,52,498,12,401,40,97,0.383,1
MTURK,2cd3cfa492db635891e3ea3b402982,3SBX2M1TKDNYBNATF1JOXQMNP15Q4X,0.03,0.0,Ben Peterson,300,18,129,12,31,6,98,0.042899999999999994,1
MTURK,2cd3cfa492db635891e3ea3b402982,3L4YG5VW9OCE3HQR3FL0YO0HAKVDDJ,0.05,1.0,Camilla Sanders,3000,42,111,14,44,28,67,0.05185,0
MTURK,2cd3cfa492db635891e3ea3b402982,39HYCOOPKPRJWO5VGQSL5S9683ZMDH,0.4,1.0,Dr Davide Orazi,7200,49,493,34,299,15,194,0.42738888888888893,1
MTURK,2cd3cfa492db635891e3ea3b402982,3XU80RHWHZG4MF9SV713ABF97NC44L,0.05,171.0,zhou yu,10800,48,1178,25,1022,23,156,0.055453703703703706,1
MTURK,2cd3cfa492db635891e3ea3b402982,3J9L0X0VDFKX5X0M6HG62BJH8UYW9P,1.0,0.0,Surveys,3600,15,630,8,560,7,70,1.175,1
MTURK,2cd3cfa492db635891e3ea3b402982,3D7VY91L78A93B0Y4N23WPT42PQBML,0.15,1.0,Patrick Healey,1800,35,220,10,77,25,143,0.16833333333333333,1
MTURK,2cd3cfa492db635891e3ea3b402982,30IRMPJWDZ40AA2CDT5CMRQKBM1KRF,0.5,0.0,Tae Rang Choi,1800,73,1147,18,42,55,1105,0.8186111111111112,1
MTURK,2cd3cfa492db635891e3ea3b402982,3NBFJK3IOIW9FZ2SPAPMDXSOG6ZGOY,0.4,0.0,Keith Wilcox,1200,89,390,19,20,70,370,0.53,1
MTURK,2cd3cfa492db635891e3ea3b402982,3TUOHPJXYHXYU9F3PRKDQ2BAWW7XWD,0.25,26.0,Lan Xia,1200,90,904,14,14,76,890,0.43833333333333335,1
MTURK,2cd3cfa492db635891e3ea3b402982,3EQVJH0T410J9HX95HYN7WFZXG6HTI,0.4,0.0,Insights Lab,1800,61,1050,16,29,45,1021,0.6333333333333333,1
MTURK,2cd3cfa492db635891e3ea3b402982,3MDWE879UI23P37VB4SV8TKJO579B5,0.3,1.0,Amanda Yamim,900,36,360,15,33,21,327,0.42,1
MTURK,2cd3cfa492db635891e3ea3b402982,32204AGAABDBVPSTNPQQ5X515FBGHC,0.27,1.0,Tung Tran,600,94,188,27,23,67,165,0.3546,1
MTURK,2cd3cfa492db635891e3ea3b402982,3BCRDCM0PHX3F40CUUMODY14FCJ6KK,1.5,1.0,Jennifer Geyer,7200,129,816,51,280,78,536,1.67,1
MTURK,2cd3cfa492db635891e3ea3b402982,3Z56AA6EK6OTBLOREPJ2AEUPCTOM6P,1.51,119.0,User Surveys,3600,26,45,11,14,15,31,1.528875,0
MTURK,2cd3cfa492db635891e3ea3b402982,3D1UCPY6HJLJ71SVLPWWYC4SOHH38Q,0.5,0.0,Cleopatra ESR3 KCL,1800,275,1421,132,971,143,450,0.8947222222222222,0
MTURK,2cd3cfa492db635891e3ea3b402982,35F6NGNVM8QREYJ9ZTXD6WU6T23T7N,1.0,109.0,Paul Eastwick,3000,37,131,12,54,25,77,1.0436666666666667,0
MTURK,2cd3cfa492db635891e3ea3b402982,3FO95NVK5CT4Y35BB9E8N81732FSR5,0.01,1.0,Declan,1800,137,412,66,256,71,156,0.012288888888888889,0
MTURK,2cd3cfa492db635891e3ea3b402982,3M0556244W9TU8NL7YJXR0LICBCFNM,0.01,1.0,Dan Popovici,180,47,204,30,164,17,40,0.021333333333333336,0
MTURK,2cd3cfa492db635891e3ea3b402982,329E6HTMSYSXANY5S47AO7196X0K3V,0.01,1.0,TATSUYA YAMAMOTO,300,85,142,35,57,50,85,0.014733333333333334,1
MTURK,2cd3cfa492db635891e3ea3b402982,3UEDKCTP9VQ6KIUI2J4OZRFGNP9K7J,0.01,2320.0,Phil Maher,3600,136,371,78,259,58,112,0.011030555555555556,0
MTURK,2cd3cfa492db635891e3ea3b402982,3FI30CQHWOMJKQ5ZAWFBZTQMW6XB6C,0.02,1.0,Rooparani V Hiremath,60,105,133,56,61,49,72,0.06433333333333333,0
MTURK,2cd3cfa492db635891e3ea3b402982,3SD19AGEVB92LTPUCFK937JERXM36X,0.02,1.0,Everyday Cognition Lab,3600,153,438,94,328,59,110,0.022433333333333333,0
MTURK,2cd3cfa492db635891e3ea3b402982,3XDSWAMB22S6EBGXI6A7U3BETB7CQK,0.03,1.0,NIKITA SAMOYLOV,3600,216,982,133,448,83,534,0.03818333333333333,0
MTURK,2cd3cfa492db635891e3ea3b402982,3OID399FYKS3UKXLWCY8HLBERK0FDZ,0.03,1.0,Ana Costa,1800,407,2114,172,654,235,1460,0.06523333333333334,0
MTURK,2cd3cfa492db635891e3ea3b402982,3T2HW4QDVYLAGFALRKIWM69F83ZC98,0.3,47.0,JHU Collaboration,900,49,360,12,111,37,249,0.42,1
MTURK,2cd3cfa492db635891e3ea3b402982,3PEG1BH7AES2VWWC41QJP2W3D9YBK3,0.75,0.0,Priyali Rajagopal,1800,109,986,27,117,82,869,1.1608333333333334,1
MTURK,2cd3cfa492db635891e3ea3b402982,37G6BXQPLQL3TW924KZSKWGWZCZEQK,0.04,121.0,DanielHendrycks,1800,161,597,76,240,85,357,0.05326666666666667,1
MTURK,2cd3cfa492db635891e3ea3b402982,3ABAOCJ4SCTVUWH0GU6YE2OYZXNQMA,0.03,1.0,Mturk1,3600,396,1512,183,509,213,1003,0.0426,1
MTURK,2cd3cfa492db635891e3ea3b402982,33N1S8XHHNCG4BT1VAYY282098BZ1A,0.05,2.0,Lucrecia Granda,1200,359,1296,164,408,195,888,0.10400000000000001,1
MTURK,2cd3cfa492db635891e3ea3b402982,35U0MRQMUJUYF0P1XV8C29H8H6POVN,0.05,44.0,Sudipta Mukherjee,3600,442,2235,199,789,243,1446,0.08104166666666668,1
MTURK,2cd3cfa492db635891e3ea3b402982,3ZUE82NE0AC0ISXEZ2L6YPTY2008FW,0.05,106.0,Alex Marshburn,3600,474,2792,185,784,289,2008,0.08877777777777779,1
MTURK,2cd3cfa492db635891e3ea3b402982,3SA4EMRVJV36X2FWS09STEKCKOY0PY,0.08,1.0,Tung Tran,300,64,202,32,40,32,162,0.13386666666666666,1
MTURK,2cd3cfa492db635891e3ea3b402982,3126F2F5F8PVQG0BKVPFEDM81WTPEJ,0.2,14.0,Christina,3600,51,174,15,57,36,117,0.20966666666666667,0
MTURK,2cd3cfa492db635891e3ea3b402982,3V8JSVE8YYQ6GGUXH2DUEKEDC10YE4,1.0,1.0,Soo Yun Shin,3600,108,1980,27,50,81,1930,1.55,1
MTURK,2cd3cfa492db635891e3ea3b402982,32XN26MTXZJ6L2CF4VOQ41XGYJF0LF,0.03,1.0,Ben Peterson,300,21,98,11,37,10,61,0.0398,1
MTURK,2cd3cfa492db635891e3ea3b402982,32FESTC2NHWD2KCHVNBJMZP4HGTUCX,0.0,1.0,Nina Xue,1800,150,913,45,55,105,858,0.0,1
MTURK,2cd3cfa492db635891e3ea3b402982,37VHPF5VYB2G865ONWKILPPH3178CT,0.15,0.0,Research University,600,57,271,13,30,44,241,0.21775,1
MTURK,2cd3cfa492db635891e3ea3b402982,3DWGH2J76OJRQGQGQJEYR6KGA6YV1N,0.8,1.0,Everyday Cognition Lab,7200,80,2112,31,487,49,1625,1.0346666666666668,1
MTURK,2cd3cfa492db635891e3ea3b402982,3IVKZBIBJZ8XDVAHRDLY8LD803VSHP,2.0,0.0,Ryan Kennedy,172800,168,13773,91,12385,77,1388,2.159409722222222,1
MTURK,2cd3cfa492db635891e3ea3b402982,3M93N4X8HKBBVI4YJ8FASZBV1GYSJV,0.3,48.0,BiggerSplash,1800,28,820,25,788,3,32,0.43666666666666665,1
MTURK,2cd3cfa492db635891e3ea3b402982,3SV8KD29L4G37EWUWL9UP78B3KYKZR,0.3,47.0,BiggerSplash,1800,148,2034,91,834,57,1200,0.639,1
MTURK,2cd3cfa492db635891e3ea3b402982,3X0EMNLXEPDN9LO08GPZ0IHE9JYPVX,0.3,45.0,BiggerSplash,1800,77,401,60,330,17,71,0.36683333333333334,1
MTURK,2cd3cfa492db635891e3ea3b402982,3TLFH2L6Y9CC4MJ51NE83NL01OR2T8,0.3,35.0,BiggerSplash,1800,67,439,47,344,20,95,0.37316666666666665,1
MTURK,2cd3cfa492db635891e3ea3b402982,3VADEH0UHCL7HT7WELKUPVX7AF4PSS,0.3,42.0,BiggerSplash,1800,30,798,28,735,2,63,0.433,1
MTURK,2cd3cfa492db635891e3ea3b402982,3EFNPKWBMSC09VIX7L432MONARU035,0.3,42.0,BiggerSplash,1800,63,811,37,739,26,72,0.43516666666666665,1
MTURK,2cd3cfa492db635891e3ea3b402982,3VZYA8PITOM3NA51L4SWHJM7ONL05V,0.3,38.0,BiggerSplash,1800,50,663,33,378,17,285,0.4105,1
MTURK,2cd3cfa492db635891e3ea3b402982,3VZYA8PITOM3NA51L4SWHJM7ONL500,0.3,33.0,BiggerSplash,1800,33,252,20,224,13,28,0.34199999999999997,1
MTURK,2cd3cfa492db635891e3ea3b402982,3SSN80MU8CCE2JWFV3L9SMS0VK0KXU,0.3,33.0,BiggerSplash,1800,74,1322,32,265,42,1057,0.5203333333333333,1
MTURK,2cd3cfa492db635891e3ea3b402982,3I7SHAD36PNK1PIRS97F7PXISVG7MS,0.98,9.0,Research i,2100,162,997,19,15,143,982,1.4452666666666667,1
MTURK,2cd3cfa492db635891e3ea3b402982,33K3E8REX0KVGEWWAVC6K215C8GX89,1.2,1.0,SARS-CoV-2 Lab,3600,178,1015,45,174,133,841,1.5383333333333333,1
MTURK,2cd3cfa492db635891e3ea3b402982,3QI9WAYOHUR6A08QYZSLWJW9ETZS67,0.75,1.0,Minda Huang,2700,77,1429,19,34,58,1395,1.1469444444444443,1
MTURK,2cd3cfa492db635891e3ea3b402982,3VDI8GSXAFTF8XDS9I29BJTTNYO8G7,0.4,1.0,Katja Berger,3600,76,824,23,306,53,518,0.4915555555555556,1
MTURK,2cd3cfa492db635891e3ea3b402982,3Z56AA6EK6HR9HAY2CPURXVRPI4M6N,0.3,2.0,Anon Ymous,3600,88,912,13,14,75,898,0.376,1
MTURK,2cd3cfa492db635891e3ea3b402982,363A7XIFW8AM3RZV3PMVP62V916VAJ,0.25,1.0,CS184FA,600,113,436,37,51,76,385,0.43166666666666664,1
MTURK,2cd3cfa492db635891e3ea3b402982,388FBO7JZRH90HP8TCC2FJP20FEYNV,0.25,1.0,Julia Minson,1800,65,473,15,332,50,141,0.31569444444444444,0
MTURK,2cd3cfa492db635891e3ea3b402982,3ZZAYRN1I6SIZA0YLVPJIALB80LTO1,0.2,1.0,Yunhui Huang,3600,235,984,97,318,138,666,0.2546666666666667,0
MTURK,2cd3cfa492db635891e3ea3b402982,3OCZWXS7ZN6PIMTXIUDY201EKWJ5LO,0.3,0.0,Colleen P. Kirk,2400,158,827,58,265,100,562,0.403375,1
MTURK,2cd3cfa492db635891e3ea3b402982,3IQ9O0AYW6AGY1JVUPM9V9HTXOOTII,0.2,39.0,ugent,900,60,352,35,241,25,111,0.27822222222222226,1
MTURK,2cd3cfa492db635891e3ea3b402982,36818Z1KV4PYIQ3VKICZHIL7N0WA3S,0.4,1.0,Anat Maril,600,23,55,13,29,10,26,0.4366666666666667,0
MTURK,2cd3cfa492db635891e3ea3b402982,37SDSEDIN9KUF0TYE1JFLI2AVXG81W,0.5,0.0,DM Lab,900,62,670,25,55,37,615,0.8722222222222222,1
MTURK,2cd3cfa492db635891e3ea3b402982,3FVBZG9CMN0XDQL2GZC6O2IUKGEH03,0.4,1.0,Justin Nguyen,1800,52,414,44,391,8,23,0.492,1
MTURK,2cd3cfa492db635891e3ea3b402982,3J6BHNX0U9PIVD1J9AJVHKB9RHCNKI,0.25,32.0,Agnes W Yang,1800,84,996,22,9,62,987,0.3883333333333333,1
MTURK,2cd3cfa492db635891e3ea3b402982,37SDSEDIN811ZYDWC8CZUFSM8CO81Q,0.6,5.0,Ryan Buell,3600,75,3275,26,14,49,3261,1.1458333333333333,0
MTURK,2cd3cfa492db635891e3ea3b402982,3X2LT8FDHWZ0Q1670VP1LO0Q4L58WL,3.5,0.0,DMU Psychology Lab,10800,367,4109,118,214,249,3895,4.83162037037037,1
MTURK,2cd3cfa492db635891e3ea3b402982,37NXA7GVST67TAEH09A0Q0QYBU9LVP,1.5,0.0,Matti,3600,87,1561,30,51,57,1510,2.1504166666666666,1
MTURK,2cd3cfa492db635891e3ea3b402982,3YKP7CX6G1EXVHZZBBBKBZUFT8GB75,1.0,1.0,daniel nagin,1500,133,927,38,38,95,889,1.6179999999999999,1
MTURK,2cd3cfa492db635891e3ea3b402982,3B6F54KMR2791YHW2SROPXU0UMCS1I,2.0,0.0,Rico Neumann,7200,217,6287,88,5847,129,440,3.746388888888889,1
MTURK,2cd3cfa492db635891e3ea3b402982,3I01FDIL6NQL03AMWDFIFZGMDQRD29,0.5,1.0,Lorenzo Cecutti,2400,2,1380,2,1380,0,0,0.7875000000000001,1
MTURK,2cd3cfa492db635891e3ea3b402982,3D0LPO3EABZ8CJUTSAGREUVU9OKOY7,0.5,1.0,The Wharton School,1800,2,360,2,360,0,0,0.6,1
MTURK,2cd3cfa492db635891e3ea3b402982,3H1C3QRA01JP1S2SNTJCOWM3T5UCEA,0.15,21.0,edirewrite,1800,34,556,31,545,3,11,0.19633333333333333,1
MTURK,2cd3cfa492db635891e3ea3b402982,3K2CEDRACB2T2WGOILZGPYTENT0MTG,0.45,1.0,David,1800,112,960,24,21,88,939,0.69,1
MTURK,2cd3cfa492db635891e3ea3b402982,3E9VAUV7BWFZ6LA0F83NY4NROYHYAQ,0.1,0.0,Marilyn Giroux,3600,197,1307,83,421,114,886,0.13630555555555557,1
MTURK,2cd3cfa492db635891e3ea3b402982,3D1TUISJWI1JQLAPW0GS4HCQSDTUIR,0.13,1.0,Tom Kramer,3600,75,590,37,147,38,443,0.15130555555555555,1
MTURK,2cd3cfa492db635891e3ea3b402982,302U8RURJZ1UCTDN1V16HXXAJLTVNA,0.3,56.0,UM,3600,37,300,7,246,30,54,0.325,1
MTURK,2cd3cfa492db635891e3ea3b402982,3TCFMTM8HECDT379JNR62NYCX28219,0.1,1.0,Arnold Lab,300,55,97,35,41,20,56,0.13233333333333336,0
MTURK,2cd3cfa492db635891e3ea3b402982,3511RHPAEZ3KAEZLZMMOUADXY2TLRJ,0.5,0.0,Amna Kirmani,3000,53,570,32,444,21,126,0.595,1
MTURK,2cd3cfa492db635891e3ea3b402982,307FVKVSYSOX9L08KR26Y7M666L47I,2.0,1.0,Market Research,4800,54,690,25,86,29,604,2.2875,0
MTURK,bdb1e5a4546e1de80f3e8d65ed5a81,3QXFBUZ4ZLGG6J9XCC0PNKJRIOPUGY,2.0,1.0,HCI Lab,7200,40,975,5,11,35,964,2.2708333333333335,1
MTURK,bdb1e5a4546e1de80f3e8d65ed5a81,3HRWUH63QUYH0SUUTREE35GCBTO5ND,0.5,1.0,Goldberg Imports,86400,33,65,20,35,13,30,0.5003761574074074,0
MTURK,bdb1e5a4546e1de80f3e8d65ed5a81,389A2A304Q8NKH25HOYIO622PKUC02,0.8,330.0,Shahar Lev,2100,37,452,34,431,3,21,0.9721904761904763,1
MTURK,bdb1e5a4546e1de80f3e8d65ed5a81,33J5JKFMK8ONVABL5THWA9PQWBF3QT,0.8,330.0,Shahar Lev,2100,177,1763,103,1106,74,657,1.4716190476190478,1
MTURK,bdb1e5a4546e1de80f3e8d65ed5a81,3J9L0X0VDHCEU9WNYBHCTBAYK45W96,0.8,330.0,Shahar Lev,2100,105,858,67,645,38,213,1.1268571428571428,0
MTURK,bdb1e5a4546e1de80f3e8d65ed5a81,35JDMRECC5SHS0NQU5X2I7CRP94EGA,2.0,1.0,Mia Park,3600,28,37,19,9,9,28,2.0205555555555557,0
MTURK,bdb1e5a4546e1de80f3e8d65ed5a81,3SZYX62S5G03BIB1LW9Z61FL64257F,11.5,1.0,Randy Corpuz,10800,166,3894,99,717,67,3177,15.64638888888889,1
MTURK,bdb1e5a4546e1de80f3e8d65ed5a81,3J6BHNX0U8RNJDPY51TNC1B3B5VNK2,0.99,1.0,PickFu,4720,27,244,13,52,14,192,1.0411779661016949,1
MTURK,bdb1e5a4546e1de80f3e8d65ed5a81,3L21G7IH47GPFZ7IV3FTXS9MMKR1YX,1.0,1.0,Stanford Open Virtual Assistant Lab,1200,14,131,14,129,0,2,1.1091666666666666,1
MTURK,bdb1e5a4546e1de80f3e8d65ed5a81,35JDMRECC49KG9VAZQZEW1UEHOTEGJ,0.8,1.0,STS Lab,10800,172,3895,111,702,61,3193,1.0885185185185184,1
MTURK,bdb1e5a4546e1de80f3e8d65ed5a81,3KG2UQJ0MJOVWL8UAMJHQ1MEJEIQNI,2.0,1.0,Alexandre Saiz Verdaguer,3600,53,5806,28,49,25,5757,5.225555555555555,0
MTURK,bdb1e5a4546e1de80f3e8d65ed5a81,3421H3BM9C7SOPWORCYX4LGQI8X9JP,0.8,307.0,Shahar Lev,2100,21,384,21,378,0,6,0.9462857142857144,1
MTURK,bdb1e5a4546e1de80f3e8d65ed5a81,3D0LPO3EADPLQ1VTF1IIBYQ3QBROYB,0.8,305.0,Shahar Lev,2100,46,647,46,628,0,19,1.0464761904761906,1
MTURK,bdb1e5a4546e1de80f3e8d65ed5a81,3M67TQBQQJEHNWTKX6LKBMD7SL39A9,0.8,303.0,Shahar Lev,2100,97,1201,92,1114,5,87,1.2575238095238097,1
MTURK,bdb1e5a4546e1de80f3e8d65ed5a81,3OKP4QVBQ675TXD7LV9ZZ4V6KB3AGD,1.5,1.0,mohammadmilad ameri,1800,108,1124,36,103,72,1021,2.4366666666666665,1
MTURK,bdb1e5a4546e1de80f3e8d65ed5a81,3L4YG5VW9NSEKX9B2HUN0798JYGDD0,1.0,13.0,Haemin Joo,3600,1456,3567,2,14,1454,3553,1.9908333333333332,1
MTURK,bdb1e5a4546e1de80f3e8d65ed5a81,30Z7M1Q8UYK45VA81ZS5OEN1N4M8AN,1.0,13.0,Haemin Joo,3600,155,900,73,366,82,534,1.25,0
MTURK,bdb1e5a4546e1de80f3e8d65ed5a81,3T5ZXGO9DF837D3LE2R2LBUMLPJZQ7,0.7,4.0,Yan Huang,3600,175,1973,27,100,148,1873,1.0836388888888888,0
MTURK,bdb1e5a4546e1de80f3e8d65ed5a81,3OZ4VAIBEXFENIBZTPHCZO86KCZJVO,0.4,1.0,Benjamin Bergen,7200,65,255,33,91,32,164,0.4141666666666667,1
MTURK,bdb1e5a4546e1de80f3e8d65ed5a81,386T3MLZLNVPZ67S0SMU37EPNHG80S,0.7,1.0,Igor Douven,1800,32,382,27,328,5,54,0.8485555555555555,1
MTURK,bdb1e5a4546e1de80f3e8d65ed5a81,31SIZS5W59GCZ1WDWRD5TUYF8SQQRN,1.09,3.0,NTB Lab,600,89,624,46,510,43,114,2.2236000000000002,0
MTURK,bdb1e5a4546e1de80f3e8d65ed5a81,3PN6H8C9R5QEYZY9A2F9I88A36VAD7,1.0,1.0,apollo,1800,161,706,83,527,78,179,1.3922222222222222,0
MTURK,bdb1e5a4546e1de80f3e8d65ed5a81,3T2EL38U0MTJ4BL2RITJM57AGNFQXC,0.4,0.0,zoyaTorrLab,1200,101,435,47,325,54,110,0.545,0
MTURK,bdb1e5a4546e1de80f3e8d65ed5a81,3UAU495MIJS4YWQV0VDXSTST9DKOUP,2.0,1.0,HCI Lab,2700,211,1045,82,356,129,689,2.774074074074074,0
MTURK,bdb1e5a4546e1de80f3e8d65ed5a81,32XN26MTXZJPYLI51J21HFYXDJUL0A,3.0,1.0,David Cheng,7200,28,592,18,405,10,187,3.2466666666666666,1
MTURK,bdb1e5a4546e1de80f3e8d65ed5a81,3E9ZFLPWOZS96QC9E5MEGKD4A8UIX1,1.2,1.0,Eric Bogert,600,49,546,27,78,22,468,2.292,1
MTURK,bdb1e5a4546e1de80f3e8d65ed5a81,3NI0WFPPI9GYG8BPZ81U1GZHUV160D,0.75,1.0,Dorit Nevo,900,24,144,19,94,5,50,0.87,1
MTURK,bdb1e5a4546e1de80f3e8d65ed5a81,37G6BXQPLQLZGES751JOMPJ62MMQE0,0.7,1.0,Eddie,3600,28,55,19,16,9,39,0.7106944444444444,0
MTURK,bdb1e5a4546e1de80f3e8d65ed5a81,3B623HUYJ4Q803FHBNDKUQWIMU48SX,2.0,1.0,Michael A Xenos,1800,99,699,53,90,46,609,2.7766666666666664,1
MTURK,bdb1e5a4546e1de80f3e8d65ed5a81,3D5G8J4N5COIZQ2XJANI4EOUSCLVTP,2.5,1.0,Teju Herath,3600,189,2000,107,380,82,1620,3.888888888888889,1
MTURK,bdb1e5a4546e1de80f3e8d65ed5a81,391FPZIE4CMH3TO1EWOCR0SG164HU7,0.5,1.0,The Wharton School,1800,126,906,64,48,62,858,0.7516666666666667,1
MTURK,bdb1e5a4546e1de80f3e8d65ed5a81,3JTPR5MTZRBJTOJS11X1IKBHKND5KI,0.35,1.0,PickFu,2746,54,193,23,14,31,179,0.3745994173343044,1
MTURK,bdb1e5a4546e1de80f3e8d65ed5a81,3ZURAPD288VYG55SWTGJERJPDU7F15,1.0,23.0,Lauren Grewal,6000,210,2053,54,71,156,1982,1.3421666666666667,1
MTURK,bdb1e5a4546e1de80f3e8d65ed5a81,3UQVX1UPGVUW5M5ALXPSKNTDZ5A20T,0.5,1.0,UPenn Researcher,3600,146,1633,39,67,107,1566,0.7268055555555556,1
MTURK,bdb1e5a4546e1de80f3e8d65ed5a81,3OLZC0DJ8JMR9A5SKWW5RLHG7OTVIU,0.5,1.0,Tuck Behavioral Research Lab,10800,268,2263,65,111,203,2152,0.6047685185185185,1
MTURK,bdb1e5a4546e1de80f3e8d65ed5a81,3FHTJGYT8PY7H1ZLQFR80H8W91ZGP2,1.25,36.0,Liz Tippett,2700,200,905,70,62,130,843,1.6689814814814814,1
MTURK,bdb1e5a4546e1de80f3e8d65ed5a81,338431Z1FNSDK5H5C9J7Y26ZTXBROL,15.0,0.0,Ricarda Pritschmann,10800,787,3765,129,257,658,3508,20.229166666666668,1
MTURK,bdb1e5a4546e1de80f3e8d65ed5a81,32XN26MTX1IC8LH2YUOHWV103KEL0N,0.4,4.0,RBC Behavioral Research Lab,1800,74,316,21,28,53,288,0.47022222222222226,1
MTURK,bdb1e5a4546e1de80f3e8d65ed5a81,31GN6YMHLPS0RB45LJSLX3K3QRPWSR,1.0,1.0,Khudejah,3600,95,424,46,20,49,404,1.1177777777777778,1
MTURK,bdb1e5a4546e1de80f3e8d65ed5a81,359AP8GAHJ33A5T3KUZANZH28EZ7C5,0.2,0.0,Violet Peng,3600,131,647,65,125,66,522,0.23594444444444446,0
MTURK,bdb1e5a4546e1de80f3e8d65ed5a81,34R3P23QHS17GDTSCEB68U94W5LWHK,0.5,19.0,NerdLab Lab Group,2400,45,260,18,9,27,251,0.5541666666666667,1
MTURK,bdb1e5a4546e1de80f3e8d65ed5a81,3N5YJ55YYKBWOBA4CFUK1FPH783ANL,1.0,1.0,Robert Jensen,3600,28,46,19,27,9,19,1.0127777777777778,0
MTURK,bdb1e5a4546e1de80f3e8d65ed5a81,3M93N4X8IO91DVULG4UKEWTJNHBJSG,10.0,0.0,R4P,7200,180,2361,90,1650,90,711,13.279166666666667,0
MTURK,bdb1e5a4546e1de80f3e8d65ed5a81,3X7837UUACXDL7V2I1OGXRVW1936JM,0.21,550.0,Aristo,3600,37,1598,29,1580,8,18,0.3032166666666667,1
MTURK,bdb1e5a4546e1de80f3e8d65ed5a81,3Z3R5YC0P34X5VJVTM4P9N6KJFYFT3,0.75,1.0,James Bisbee,3600,28,134,18,62,10,72,0.7779166666666667,1
MTURK,bdb1e5a4546e1de80f3e8d65ed5a81,3KLL7H3EGFOB38BYN2A0KDEA31GVH6,2.5,1.0,Samantha Rundle,3600,28,68,20,35,8,33,2.547222222222222,0
MTURK,bdb1e5a4546e1de80f3e8d65ed5a81,31N9JPQXIP2A2SJUIMJJOE2G5LGNH6,0.2,1.0,OSU Spatial Health Lab,600,38,73,17,48,21,25,0.22433333333333336,0
MTURK,bdb1e5a4546e1de80f3e8d65ed5a81,3A520CCNXQG49L133O6U2OFZUIJEA5,1.0,1.0,Thenuka Karunaratne,900,67,105,36,23,31,82,1.1166666666666667,1
MTURK,bdb1e5a4546e1de80f3e8d65ed5a81,3KQC8JMJGDZUJ5BFKN62EMY1ESH3HZ,0.75,1.0,eijiro kaga,86400,71,219,30,155,41,64,0.7519010416666667,1
MTURK,bdb1e5a4546e1de80f3e8d65ed5a81,386659BNTKGC7YVWEEB65F104EL109,0.75,112.0,Yphtach Lelkes,1800,3,303,3,303,0,0,0.87625,1
MTURK,bdb1e5a4546e1de80f3e8d65ed5a81,31J7RYECZN7NR4ZN34VNZMVLZ67L1Z,2.0,1.0,Canlabresearch01,5400,155,972,26,319,129,653,2.36,1
MTURK,bdb1e5a4546e1de80f3e8d65ed5a81,35U0MRQMUJ7JSDN0N6SFPCIQI8NVOB,1.0,1.0,SS Behavior Lab,3600,47,38,21,14,26,24,1.0105555555555557,0
MTURK,bdb1e5a4546e1de80f3e8d65ed5a81,36MUZ9VAE6OER78XHOBNS7DAEBDDET,1.0,1.0,Bai Ying Song,1800,45,78,20,10,25,68,1.0433333333333334,0
MTURK,bdb1e5a4546e1de80f3e8d65ed5a81,3EHVO81VN5LUOEGLU2AHW790SU01HQ,0.7,1.0,Patrick,3600,53,246,21,37,32,209,0.7478333333333332,1
MTURK,bdb1e5a4546e1de80f3e8d65ed5a81,3LAZVA75NHQ3KM92O2UL5VVO43FO2T,0.36,1.0,Stanford GSB Behavioral Lab,1800,40,31,16,3,24,28,0.36619999999999997,0
MTURK,bdb1e5a4546e1de80f3e8d65ed5a81,3UQVX1UPFTIYYKB3XQWHJ9S7XYU02C,1.5,1.0,Julian Schaap,10800,66,466,34,78,32,388,1.5647222222222221,1
MTURK,bdb1e5a4546e1de80f3e8d65ed5a81,3H5TOKO3ECXVUMMHWP1FB7Q5JSL64K,1.0,1.0,zhibo xu,1200,53,261,34,50,19,211,1.2175,1
MTURK,bdb1e5a4546e1de80f3e8d65ed5a81,36D1BWBEIQET80CHA2CQIK0Q2CUM2F,0.4,1.0,UPenn Researcher,3600,38,50,13,21,25,29,0.40555555555555556,0
MTURK,bdb1e5a4546e1de80f3e8d65ed5a81,3WJGKMRWVJEDSH4ZJTO9BL3W0YYDCU,1.05,1.0,Jano,3600,40,387,25,173,15,214,1.162875,1
MTURK,bdb1e5a4546e1de80f3e8d65ed5a81,3Y7LTZE0YTMOOW727M64KIZHN31ZUJ,1.0,33.0,Diana,7200,69,71,26,16,43,55,1.009861111111111,0
MTURK,bdb1e5a4546e1de80f3e8d65ed5a81,3MGHRFQY2L8QUCHKIJ1E9Q3BYSGY0D,0.4,9.0,Jacob Brazeal,300,12,43,12,40,0,3,0.45733333333333337,1
MTURK,bdb1e5a4546e1de80f3e8d65ed5a81,3WGZLY9VCHRIVYSPIWORTJC8OXV8DT,3.75,0.0,Research Methods,7200,244,3738,35,52,209,3686,5.696875,1
MTURK,bdb1e5a4546e1de80f3e8d65ed5a81,3TUOHPJXYHN2ZPPOBE36GMEZGGYWXI,3.5,0.0,EMP Lab,7200,210,933,63,157,147,776,3.9535416666666667,1
MTURK,bdb1e5a4546e1de80f3e8d65ed5a81,37ZQELHER4NW5CF4EJB3UABF799NMQ,1.0,1.0,Fabrizio Cecchettini,300,92,152,48,138,44,14,1.5066666666666668,1
MTURK,bdb1e5a4546e1de80f3e8d65ed5a81,356TQKY9XFXT9R8W1G6COZC280I78I,2.0,13.0,Ashley Lytle,2400,159,699,76,158,83,541,2.5825,1
MTURK,bdb1e5a4546e1de80f3e8d65ed5a81,3OID399FXG7XXD93RKNY19DWBGNDF5,2.5,1.0,David Cheng,3600,169,1804,74,83,95,1721,3.7527777777777778,0
MTURK,bdb1e5a4546e1de80f3e8d65ed5a81,3O71U79SRBPICBPBKM9JF16N053MSA,2.0,0.0,SNAP,3600,167,2074,66,52,101,2022,3.152222222222222,0
MTURK,bdb1e5a4546e1de80f3e8d65ed5a81,3ZQX1VYFUHSFQ562UBIUEZOY3WQO8C,0.3,1.0,Conversionxl LLC,14400,268,8565,115,180,153,8385,0.47843749999999996,0
MTURK,bdb1e5a4546e1de80f3e8d65ed5a81,3HJ1EVZS2OJATTPLVH45IV4MB5SR3M,0.5,1.0,The Wharton School,2700,50,164,17,16,33,148,0.5303703703703704,0
MTURK,bdb1e5a4546e1de80f3e8d65ed5a81,3GV1I4SEO978KMRAE9HGPDDJPXIL6F,2.25,1.0,Andy Dissertator,3600,50,366,33,91,17,275,2.47875,1
MTURK,bdb1e5a4546e1de80f3e8d65ed5a81,3S1L4CQSG1T8LPO6Z1W060XMWZPFAE,0.75,1.0,Survey Launcher,1800,99,239,17,8,82,231,0.8495833333333334,1
MTURK,bdb1e5a4546e1de80f3e8d65ed5a81,3PA41K45WRQNLQSITH32B7Y3M7PP7N,2.5,1.0,Michael Kowalski,7200,60,393,32,21,28,372,2.6364583333333336,1
MTURK,bdb1e5a4546e1de80f3e8d65ed5a81,3OREP8RUU58EU222NBQ26GQR37WGBK,0.5,1.0,Viga_TCB,1800,167,404,84,104,83,300,0.6122222222222222,1
MTURK,bdb1e5a4546e1de80f3e8d65ed5a81,3H6W48L9G88UOJDQKHVHXH221P6WP8,3.5,1.0,Elizabeth Shelleby,86400,296,2136,168,463,128,1673,3.586527777777778,1
MTURK,bdb1e5a4546e1de80f3e8d65ed5a81,3E22YV8GG16C6L972EP8J3H5JC5PNT,1.0,1.0,David,3600,180,613,96,213,84,400,1.1702777777777778,1
MTURK,bdb1e5a4546e1de80f3e8d65ed5a81,3NRZ1LDP7W69EHNZCF1LBVYKXVBPZ8,0.83,65.0,Chris Callison-Burch,3600,209,837,120,426,89,411,1.022975,1
MTURK,bdb1e5a4546e1de80f3e8d65ed5a81,335HHSX8CE7VCUBT65D5CJXGYDFDH5,0.8,1231.0,NYU Bowman Group,86400,42,145,26,88,16,57,0.8013425925925927,1
MTURK,bdb1e5a4546e1de80f3e8d65ed5a81,301KG0KX9DN89KDD9GTOG06C1MQ2HL,0.8,1156.0,NYU Bowman Group,86400,71,258,36,101,35,157,0.8023888888888889,0
MTURK,bdb1e5a4546e1de80f3e8d65ed5a81,3GMLHYZ0LFZ3FRC4207I8JW7A9MYUY,0.8,0.0,NYU Bowman Group,86400,847,4361,477,2966,370,1395,0.8403796296296296,0
MTURK,bdb1e5a4546e1de80f3e8d65ed5a81,3UXQ63NLAA5Z3X6B4M8MWT9B9O7BLW,1.0,17.0,Saku Sugawara,1800,33,69,20,25,13,44,1.0383333333333333,0
MTURK,bdb1e5a4546e1de80f3e8d65ed5a81,3BC9H1KCYVEG7V19X0MJQ7H4VPXWYV,0.8,902.0,NYU Bowman Group,86400,37,143,24,78,13,65,0.8013240740740741,1
MTURK,bdb1e5a4546e1de80f3e8d65ed5a81,3OZ4VAIBEXFWJMFRG57YTTZC0LZVJE,0.83,51.0,Chris Callison-Burch,3600,40,322,30,174,10,148,0.9042388888888888,1
MTURK,bdb1e5a4546e1de80f3e8d65ed5a81,3O4VWC1GEW6C7DD8WV1SAY7T916J35,0.83,47.0,Chris Callison-Burch,3600,126,2338,48,1960,78,378,1.369038888888889,1
MTURK,bdb1e5a4546e1de80f3e8d65ed5a81,3VEI3XUCZRX0CQ182Y78PSWLOESPRF,0.83,46.0,Chris Callison-Burch,3600,70,276,42,220,28,56,0.8936333333333333,1
MTURK,bdb1e5a4546e1de80f3e8d65ed5a81,3ZLW647WALVC1HF0PAV0BHLC7QL323,0.83,42.0,Chris Callison-Burch,3600,32,151,32,144,0,7,0.8648138888888889,1
MTURK,bdb1e5a4546e1de80f3e8d65ed5a81,3SSN80MU8COJYVQ4Y58SITWAVL7XKI,0.83,40.0,Chris Callison-Burch,3600,33,178,33,139,0,39,0.8710388888888888,1
MTURK,bdb1e5a4546e1de80f3e8d65ed5a81,3GMLHYZ0LEXM1WLQXFYW7UCHZIZUYI,0.83,37.0,Chris Callison-Burch,3600,32,189,32,131,0,58,0.873575,1
MTURK,bdb1e5a4546e1de80f3e8d65ed5a81,3TLFH2L6Y9OH0YDU4P1RTUPA1PXT29,0.83,31.0,Chris Callison-Burch,3600,48,169,45,112,3,57,0.8689638888888889,1
MTURK,bdb1e5a4546e1de80f3e8d65ed5a81,31S7M7DAGGQN1KZ2EVJW8QOJ7POLTQ,0.83,5.0,Chris Callison-Burch,3600,467,349,282,138,185,211,0.9104638888888889,0
MTURK,bdb1e5a4546e1de80f3e8d65ed5a81,3LN50BUKPVBP9S6VXEAC3GNMIM3LPL,0.83,0.0,Chris Callison-Burch,3600,521,1337,316,1026,205,311,1.1382527777777778,0
MTURK,bdb1e5a4546e1de80f3e8d65ed5a81,36AZSFEYZ40Q13HFSDUHV5GZSGQVBT,0.83,0.0,Chris Callison-Burch,3600,529,1479,328,1131,201,348,1.1709916666666667,0
MTURK,bdb1e5a4546e1de80f3e8d65ed5a81,3FK4G712NX09QXHD94B7A76SX0ISSM,0.83,0.0,Chris Callison-Burch,3600,538,1654,342,1294,196,360,1.2113388888888887,0
MTURK,bdb1e5a4546e1de80f3e8d65ed5a81,38G0E1M85M55X2QLS4BC0V8NH1XUV9,0.83,0.0,Chris Callison-Burch,3600,545,1890,354,1485,191,405,1.26575,0
MTURK,bdb1e5a4546e1de80f3e8d65ed5a81,3538U0YQ1FUW2BRCD5A7V0F1GUQ3FN,0.83,0.0,Chris Callison-Burch,3600,571,2065,382,1637,189,428,1.3060972222222222,0
MTURK,bdb1e5a4546e1de80f3e8d65ed5a81,3CO05SML7V5XO9XOLDSIARVDG6H0RK,0.83,0.0,Chris Callison-Burch,3600,588,2961,404,2481,184,480,1.5126749999999998,0
MTURK,bdb1e5a4546e1de80f3e8d65ed5a81,3FO95NVK5C0XPIH0UFB2KX1WBYZSRY,0.83,0.0,Chris Callison-Burch,3600,596,3077,417,2546,179,531,1.5394194444444445,0
MTURK,bdb1e5a4546e1de80f3e8d65ed5a81,35YHTYFL1G3GEKTVXFGDEV7K7EIVFB,0.83,0.0,Chris Callison-Burch,3600,614,3223,440,2690,174,533,1.5730805555555554,0
MTURK,bdb1e5a4546e1de80f3e8d65ed5a81,386T3MLZLNVR64ISM4MIJA08QET088,0.83,0.0,Chris Callison-Burch,3600,613,3338,444,2765,169,573,1.5995944444444443,0
MTURK,bdb1e5a4546e1de80f3e8d65ed5a81,3MGHRFQY2LP6LA9AZ8KCINOAJTVY0J,0.83,0.0,Chris Callison-Burch,3600,635,3484,465,2908,170,576,1.6332555555555555,0
MTURK,bdb1e5a4546e1de80f3e8d65ed5a81,3B286OTISEHCRYCT5AG2X6LZFBYJA1,0.83,0.0,Chris Callison-Burch,3600,689,3567,496,2954,193,613,1.6523916666666665,0
MTURK,bdb1e5a4546e1de80f3e8d65ed5a81,3E6L1VR4XWMVZUEUW78523RLQLS6FW,0.83,0.0,Chris Callison-Burch,3600,677,3561,489,2953,188,608,1.6510083333333334,0
MTURK,bdb1e5a4546e1de80f3e8d65ed5a81,3M47JKRKCX1MKF47OT2ZSBAZ3HF68F,0.83,0.0,Chris Callison-Burch,3600,832,3587,566,2964,266,623,1.6570027777777776,0
MTURK,bdb1e5a4546e1de80f3e8d65ed5a81,3UUIU9GZC559ZVWHM83PR1SMLZP5TN,0.83,0.0,Chris Callison-Burch,3600,822,3582,561,2963,261,619,1.65585,0
MTURK,bdb1e5a4546e1de80f3e8d65ed5a81,37NXA7GVST62EC3RJQJB98C44A4VLG,0.83,0.0,Chris Callison-Burch,3600,810,3578,554,2963,256,615,1.6549277777777776,0
MTURK,bdb1e5a4546e1de80f3e8d65ed5a81,3XEDXEGFX3OB15KTVTJL9F9ZLEN0KR,0.83,0.0,Chris Callison-Burch,3600,798,3573,547,2963,251,610,1.653775,0
MTURK,bdb1e5a4546e1de80f3e8d65ed5a81,388CL5C1RJNXWB87E127U7LVWVTLHG,0.83,0.0,Chris Callison-Burch,3600,780,3568,534,2962,246,606,1.652622222222222,0
MTURK,bdb1e5a4546e1de80f3e8d65ed5a81,36GJS3V78VQD1PPWRA8CTSW2D6BJGD,0.83,0.0,Chris Callison-Burch,3600,768,3564,527,2962,241,602,1.6517,0
MTURK,bdb1e5a4546e1de80f3e8d65ed5a81,3OLZC0DJ8JF0OBVLYNMYHSKCN6AVI2,0.83,0.0,Chris Callison-Burch,3600,756,3560,520,2961,236,599,1.6507777777777777,0
MTURK,bdb1e5a4546e1de80f3e8d65ed5a81,3L21G7IH47W6SZUSVROCWS7KOL1Y1M,0.83,3.0,Chris Callison-Burch,3600,870,3586,574,2970,296,616,1.656772222222222,0
MTURK,bdb1e5a4546e1de80f3e8d65ed5a81,31JUPBOORN44307EBX81HUSWTC3L81,0.83,3.0,Chris Callison-Burch,3600,858,3581,567,2970,291,611,1.6556194444444443,0
MTURK,bdb1e5a4546e1de80f3e8d65ed5a81,3U18MJKL1UMW330C4M4LW8S4OYONCB,0.83,3.0,Chris Callison-Burch,3600,846,3577,560,2970,286,607,1.654697222222222,0
MTURK,bdb1e5a4546e1de80f3e8d65ed5a81,3WKGUBL7SZM3KZKCZUIO0ICRRQ7L4U,0.83,3.0,Chris Callison-Burch,3600,834,3573,553,2970,281,603,1.653775,0
MTURK,bdb1e5a4546e1de80f3e8d65ed5a81,3KQC8JMJGCSGG7II8VY7YLREW933HL,0.83,3.0,Chris Callison-Burch,3600,740,3508,512,2959,228,549,1.6387888888888889,0
MTURK,bdb1e5a4546e1de80f3e8d65ed5a81,3IHWR4LC7DD2DZZ8QUBOPE04C89I8K,0.83,0.0,Chris Callison-Burch,3600,87,198,75,126,12,72,0.8756499999999999,1
MTURK,bdb1e5a4546e1de80f3e8d65ed5a81,3ZFRE2BDQ9EENQPQY6B258KNZUJZX5,0.83,1.0,Chris Callison-Burch,3600,130,311,106,3767,24,-3456,0.9017027777777777,0
MTURK,bdb1e5a4546e1de80f3e8d65ed5a81,38RHULDV9YFD30VQOXRU3U3QUFCIWZ,0.83,4.0,Chris Callison-Burch,3600,176,456,135,3850,41,-3394,0.9351333333333333,0
MTURK,bdb1e5a4546e1de80f3e8d65ed5a81,36GJS3V78VQD1PPWRA8CTSW2D6BGJA,0.83,4.0,Chris Callison-Burch,3600,190,570,149,3966,41,-3396,0.9614166666666666,0
MTURK,bdb1e5a4546e1de80f3e8d65ed5a81,3M0556243SK36FKMVOUM4ED7LBGFNE,0.83,2.0,Chris Callison-Burch,3600,224,746,170,4056,54,-3310,1.0019944444444444,0
MTURK,bdb1e5a4546e1de80f3e8d65ed5a81,34D9ZRXCYRU5Q1VJS4PGP7CMBUBSAQ,0.83,2.0,Chris Callison-Burch,3600,176,540,128,323,48,217,0.9544999999999999,0
MTURK,bdb1e5a4546e1de80f3e8d65ed5a81,302U8RURJZ13UFUL6UB7RTOUL3IVNY,0.45,1.0,Wesley Buckwalter,7200,437,1109,223,4937,214,-3828,0.5193125000000001,0
MTURK,bdb1e5a4546e1de80f3e8d65ed5a81,3BKZLF990Z8GZK8ZWGLNV70DJ4EQYQ,0.34,1.0,AudioKite,3600,288,834,143,422,145,412,0.41876666666666673,0
MTURK,bdb1e5a4546e1de80f3e8d65ed5a81,3UOMW19E6D6SDEU60M8Z2RSIXDOC5A,0.83,291.0,Chris Callison-Burch,3600,69,334,51,309,18,25,0.9070055555555555,1
MTURK,bdb1e5a4546e1de80f3e8d65ed5a81,39I4RL8QGJH1Y31M893Q8QJKA9Y4H6,0.83,290.0,Chris Callison-Burch,3600,391,972,197,5127,194,-4155,1.0541,0
MTURK,bdb1e5a4546e1de80f3e8d65ed5a81,36818Z1KV3BLDJJ5CJC2SP6AUL83A1,0.5,1.0,Sophie,300,101,254,45,91,56,163,0.9233333333333333,1
MTURK,bdb1e5a4546e1de80f3e8d65ed5a81,3MJ9GGZYO3669RE4ZOHD2U22Q56A2B,1.01,0.0,Sean Coary,3600,261,687,112,4970,149,-4283,1.2027416666666666,1
MTURK,bdb1e5a4546e1de80f3e8d65ed5a81,311HQEI8RSGK8BJZGT74B97ZX14Z7A,0.83,291.0,Chris Callison-Burch,3600,143,1273,77,1106,66,167,1.1234972222222221,1
MTURK,bdb1e5a4546e1de80f3e8d65ed5a81,3GITHABACYLJ5L8A7TFFKVJIC7B2NH,0.83,290.0,Chris Callison-Burch,3600,43,222,32,154,11,68,0.8811833333333333,1
MTURK,bdb1e5a4546e1de80f3e8d65ed5a81,3HUR21WDDUPEI0FL2K9JR1BLT0FYXD,0.83,289.0,Chris Callison-Burch,3600,100,534,41,227,59,307,0.9531166666666666,1
MTURK,bdb1e5a4546e1de80f3e8d65ed5a81,30EV7DWJTVV1ZLVP1X0TROY1WWH6YS,0.83,288.0,Chris Callison-Burch,3600,80,332,52,284,28,48,0.9065444444444444,0
MTURK,bdb1e5a4546e1de80f3e8d65ed5a81,3TC2K6WK9G2Y2EL61RQW2YTNNCC28T,0.83,286.0,Chris Callison-Burch,3600,34,1113,34,1100,0,13,1.0866083333333334,1
MTURK,bdb1e5a4546e1de80f3e8d65ed5a81,3Z56AA6EK401546BIUCIXTBUNM36M2,0.83,286.0,Chris Callison-Burch,3600,36,228,36,180,0,48,0.8825666666666666,1
MTURK,bdb1e5a4546e1de80f3e8d65ed5a81,3IZVJEBJ6AK14B5UXJ2C5V732QL6ZJ,0.83,286.0,Chris Callison-Burch,3600,32,255,32,203,0,52,0.8887916666666666,1
MTURK,bdb1e5a4546e1de80f3e8d65ed5a81,341H3G5YF0E6Q0JFVUMVWUXCPNYZ0A,0.83,285.0,Chris Callison-Burch,3600,24,247,24,189,0,58,0.8869472222222222,1
MTURK,bdb1e5a4546e1de80f3e8d65ed5a81,388CL5C1RJNXWB87E127U7LVWVTHLC,0.83,285.0,Chris Callison-Burch,3600,60,300,35,270,25,30,0.8991666666666667,1
MTURK,bdb1e5a4546e1de80f3e8d65ed5a81,3MJ9GGZYO36CL2ELYPAAYPZID0C2AX,0.83,284.0,Chris Callison-Burch,3600,45,735,38,660,7,75,0.9994583333333333,1
MTURK,bdb1e5a4546e1de80f3e8d65ed5a81,3CMV9YRYP31TNH3X215S6K1A9NXJLJ,0.83,284.0,Chris Callison-Burch,3600,167,882,130,687,37,195,1.03335,0
MTURK,bdb1e5a4546e1de80f3e8d65ed5a81,3RWB1RTQDJNUULMC3P18YB1GYM4P83,0.83,266.0,Chris Callison-Burch,3600,27,216,27,208,0,8,0.8797999999999999,1
MTURK,bdb1e5a4546e1de80f3e8d65ed5a81,36U4VBVNQODD4V94JK62ZYJKWVKRUD,0.83,266.0,Chris Callison-Burch,3600,31,202,31,159,0,43,0.8765722222222222,1
MTURK,bdb1e5a4546e1de80f3e8d65ed5a81,3J94SKDEKIP2I60K0I3AMXA0ID05D3,0.83,265.0,Chris Callison-Burch,3600,47,160,47,152,0,8,0.8668888888888888,1
MTURK,bdb1e5a4546e1de80f3e8d65ed5a81,311HQEI8RSGK8BJZGT74B97ZX157ZJ,0.83,263.0,Chris Callison-Burch,3600,60,352,60,255,0,97,0.9111555555555555,1
MTURK,bdb1e5a4546e1de80f3e8d65ed5a81,32TMVRKDGNY85S0T559KVDQL7Q884V,0.83,254.0,Chris Callison-Burch,3600,64,439,53,340,11,99,0.9312138888888888,1
MTURK,bdb1e5a4546e1de80f3e8d65ed5a81,3PUV2Q8SV4447MHT1SUNPJASS9MDBC,0.83,213.0,Chris Callison-Burch,3600,75,1763,52,1642,23,121,1.2364694444444444,1
MTURK,bdb1e5a4546e1de80f3e8d65ed5a81,3G57RS03HH5FFW243TJTQEJWLMB52U,0.83,208.0,Chris Callison-Burch,3600,61,155,43,120,18,35,0.865736111111111,1
MTURK,bdb1e5a4546e1de80f3e8d65ed5a81,3G4VVJO6PZGEPMODCEYBOGA7TMYKPH,0.83,207.0,Chris Callison-Burch,3600,60,224,35,165,25,59,0.8816444444444445,1
MTURK,bdb1e5a4546e1de80f3e8d65ed5a81,3D3B8GE892RU8Q5M8H7MY7WRISMP9S,0.83,205.0,Chris Callison-Burch,3600,34,132,32,28,2,104,0.8604333333333333,1
MTURK,bdb1e5a4546e1de80f3e8d65ed5a81,3UY4PIS8QRLCG0QEOPF1FC9DK1XN1L,0.83,203.0,Chris Callison-Burch,3600,61,245,50,207,11,38,0.8864861111111111,1
MTURK,bdb1e5a4546e1de80f3e8d65ed5a81,3X878VYTIEIE3USZFHDX8HRHLWB7FV,0.83,202.0,Chris Callison-Burch,3600,76,167,50,106,26,61,0.8685027777777777,1
MTURK,bdb1e5a4546e1de80f3e8d65ed5a81,3AJA9FLWSCYBSE9VY8HUZ6HQZCMFIY,0.83,201.0,Chris Callison-Burch,3600,56,164,41,85,15,79,0.8678111111111111,1
MTURK,bdb1e5a4546e1de80f3e8d65ed5a81,3RIHDBQ1NEYH2TQSED3MUK0KW0JMHJ,0.83,200.0,Chris Callison-Burch,3600,48,173,39,86,9,87,0.869886111111111,1
MTURK,bdb1e5a4546e1de80f3e8d65ed5a81,3FDWKV9VCN2M7FWCECALDZPAQ8LUMS,0.83,198.0,Chris Callison-Burch,3600,71,342,51,219,20,123,0.9088499999999999,1
MTURK,bdb1e5a4546e1de80f3e8d65ed5a81,3XWUWJ18TLQ5KN1LNE1749643UOUUK,0.83,196.0,Chris Callison-Burch,3600,61,225,49,179,12,46,0.881875,1
MTURK,bdb1e5a4546e1de80f3e8d65ed5a81,39KV3A5D187N7ZXLL1DWFGAWAM57SE,0.83,173.0,Chris Callison-Burch,3600,94,2419,57,2280,37,139,1.387713888888889,1
MTURK,bdb1e5a4546e1de80f3e8d65ed5a81,3PIOQ99R7YMSPXHCQDPLQEEAVYVUNS,0.83,172.0,Chris Callison-Burch,3600,76,163,54,90,22,73,0.8675805555555555,1
MTURK,bdb1e5a4546e1de80f3e8d65ed5a81,3GKAWYFRAPT6BGI3KXCOK3FH9D1PD9,0.83,170.0,Chris Callison-Burch,3600,53,146,41,87,12,59,0.8636611111111111,1
MTURK,bdb1e5a4546e1de80f3e8d65ed5a81,3XT3KXP24ZYF9LGKXFEQ504D6DJI6Y,0.83,169.0,Chris Callison-Burch,3600,35,141,34,90,1,51,0.8625083333333333,1
MTURK,bdb1e5a4546e1de80f3e8d65ed5a81,3XQ4XW3OD9CGLY0FFPW1JPTOZ6JS2J,0.83,166.0,Chris Callison-Burch,3600,71,199,53,119,18,80,0.8758805555555556,1
MTURK,bdb1e5a4546e1de80f3e8d65ed5a81,3VDI8GSXAFTOH8TD06BL42NOXVHG8Q,0.83,165.0,Chris Callison-Burch,3600,37,135,35,83,2,52,0.8611249999999999,1
MTURK,bdb1e5a4546e1de80f3e8d65ed5a81,3SX4X51T809QS93QLN87522LE58AOB,0.83,164.0,Chris Callison-Burch,3600,104,188,60,85,44,103,0.8733444444444444,1
MTURK,bdb1e5a4546e1de80f3e8d65ed5a81,3WGZLY9VCHML5OJMYGADYHKRK31D8D,0.83,163.0,Chris Callison-Burch,3600,57,142,39,66,18,76,0.8627388888888888,1
MTURK,bdb1e5a4546e1de80f3e8d65ed5a81,3VP28W7DUNKXN4Y5YC5GZ1KGVPOFZV,0.83,162.0,Chris Callison-Burch,3600,90,182,51,128,39,54,0.8719611111111111,1
MTURK,bdb1e5a4546e1de80f3e8d65ed5a81,3DQYSJDTYLBGCVYU2JXPKYJ5BOBXEY,0.83,161.0,Chris Callison-Burch,3600,57,184,38,99,19,85,0.8724222222222222,1
MTURK,bdb1e5a4546e1de80f3e8d65ed5a81,3JTPR5MTZSCAWC6USZPXQA5Q2MX5KG,0.83,141.0,Chris Callison-Burch,3600,35,142,35,96,0,46,0.8627388888888888,1
MTURK,bdb1e5a4546e1de80f3e8d65ed5a81,3KA7IJSNW65DWJKJ61LIPDRH6SPPB2,0.83,137.0,Chris Callison-Burch,3600,32,104,32,52,0,52,0.8539777777777777,1
MTURK,bdb1e5a4546e1de80f3e8d65ed5a81,3CRWSLD91K4RUACFIQYCETXL8MXMO7,0.83,136.0,Chris Callison-Burch,3600,75,189,52,142,23,47,0.873575,1
MTURK,bdb1e5a4546e1de80f3e8d65ed5a81,3IKDQS3DQE04P2PL76RTR0WN2ZUICQ,0.83,133.0,Chris Callison-Burch,3600,90,174,53,97,37,77,0.8701166666666666,1
MTURK,bdb1e5a4546e1de80f3e8d65ed5a81,375VMB7D4JJEUUVZ72M4B6E5NZ6IDQ,0.83,131.0,Chris Callison-Burch,3600,54,143,38,112,16,31,0.8629694444444445,1
MTURK,bdb1e5a4546e1de80f3e8d65ed5a81,30IRMPJWDZJZ1Z4SP620TBAMU4MKR9,0.83,129.0,Chris Callison-Burch,3600,83,277,57,140,26,137,0.8938638888888888,1
MTURK,bdb1e5a4546e1de80f3e8d65ed5a81,3UUSLRKAUL3H5AE3OBI7KHOW9JVD7Q,0.83,125.0,Chris Callison-Burch,3600,66,172,47,122,19,50,0.8696555555555555,1
MTURK,bdb1e5a4546e1de80f3e8d65ed5a81,3UAU495MIISA7IHORSPY53EFL80UO7,0.83,122.0,Chris Callison-Burch,3600,65,253,53,224,12,29,0.8883305555555555,1
MTURK,bdb1e5a4546e1de80f3e8d65ed5a81,3J9UN9O9J3SGQLEBD8J9809M6PMJ0A,0.83,121.0,Chris Callison-Burch,3600,139,334,68,200,71,134,0.9070055555555555,1
MTURK,bdb1e5a4546e1de80f3e8d65ed5a81,3FDWKV9VCN2M7FWCECALDZPAQ8LMUK,0.83,119.0,Chris Callison-Burch,3600,83,210,49,76,34,134,0.8784166666666666,1
MTURK,bdb1e5a4546e1de80f3e8d65ed5a81,3W0KKJIARR9TJUPWQXW02UFH4CYK8X,0.83,117.0,Chris Callison-Burch,3600,39,161,36,139,3,22,0.8671194444444444,1
MTURK,bdb1e5a4546e1de80f3e8d65ed5a81,35YHTYFL1G3GEKTVXFGDEV7K7EIFVV,0.83,116.0,Chris Callison-Burch,3600,75,181,54,147,21,34,0.8717305555555556,1
MTURK,bdb1e5a4546e1de80f3e8d65ed5a81,3PZDSVZ3J5HT8ZNXB7Y3DAGGWL7N4Y,0.83,114.0,Chris Callison-Burch,3600,114,290,63,164,51,126,0.8968611111111111,1
MTURK,bdb1e5a4546e1de80f3e8d65ed5a81,3B623HUYJ4QR7D24V652TG6RL6BS8M,0.83,112.0,Chris Callison-Burch,3600,60,128,42,87,18,41,0.8595111111111111,1
MTURK,bdb1e5a4546e1de80f3e8d65ed5a81,3WUVMVA7OB32RDHXNWJOL09PY9BAZD,0.83,108.0,Chris Callison-Burch,3600,49,770,44,725,5,45,1.0075277777777778,1
MTURK,bdb1e5a4546e1de80f3e8d65ed5a81,33CLA8O0MIBOLDCEOVB3DYIHM85FR2,0.83,106.0,Chris Callison-Burch,3600,34,129,32,72,2,57,0.8597416666666666,1
MTURK,bdb1e5a4546e1de80f3e8d65ed5a81,3BO3NEOQM0HGWNSNNSV2L56Z2W9AIG,0.83,105.0,Chris Callison-Burch,3600,147,366,73,242,74,124,0.9143833333333333,1
MTURK,bdb1e5a4546e1de80f3e8d65ed5a81,3UL5XDRDNCJQ1B4TJASU05WZ7M3850,0.83,101.0,Chris Callison-Burch,3600,114,359,69,256,45,103,0.9127694444444444,1
MTURK,bdb1e5a4546e1de80f3e8d65ed5a81,3JMQI2OLFZ568V6Q4IZWGEAM9Y0DN1,0.83,98.0,Chris Callison-Burch,3600,137,369,65,161,72,208,0.915075,1
MTURK,bdb1e5a4546e1de80f3e8d65ed5a81,3VJ4PFXFJ37L5ENNH9KG48UAWRWAUO,0.83,97.0,Chris Callison-Burch,3600,79,177,51,135,28,42,0.8708083333333333,1
MTURK,bdb1e5a4546e1de80f3e8d65ed5a81,3MVY4USGB6NKWJEH4SHT6505O2GISK,0.83,88.0,Chris Callison-Burch,3600,119,1206,68,1061,51,145,1.10805,1
MTURK,bdb1e5a4546e1de80f3e8d65ed5a81,391JB9X4ZY884JR0KY6J7CGCOHNKML,0.83,87.0,Chris Callison-Burch,3600,73,224,58,153,15,71,0.8816444444444445,1
MTURK,bdb1e5a4546e1de80f3e8d65ed5a81,3Z3R5YC0P3N11SP6SKGYDDJZAT2FTF,0.83,82.0,Chris Callison-Burch,3600,95,276,55,89,40,187,0.8936333333333333,1
MTURK,bdb1e5a4546e1de80f3e8d65ed5a81,3G9UA71JVVUU8WEVY74INFJ9E3S7JY,0.83,83.0,Chris Callison-Burch,3600,39,249,35,148,4,101,0.8874083333333332,1
MTURK,bdb1e5a4546e1de80f3e8d65ed5a81,37PGLWGSJT6M8019ZJ8RFJ9V783IK3,0.83,80.0,Chris Callison-Burch,3600,50,203,44,181,6,22,0.8768027777777777,1
MTURK,bdb1e5a4546e1de80f3e8d65ed5a81,3GVPRXWRPHUYDLUPGPJIBE491O37IM,0.83,78.0,Chris Callison-Burch,3600,94,244,57,153,37,91,0.8862555555555555,1
MTURK,bdb1e5a4546e1de80f3e8d65ed5a81,3M47JKRKCX1MKF47OT2ZSBAZ3HE86G,0.83,75.0,Chris Callison-Burch,3600,53,311,44,227,9,84,0.9017027777777777,1
MTURK,bdb1e5a4546e1de80f3e8d65ed5a81,3RZS0FBRWKAW6OCPK1HD0XXZODPPC9,0.83,73.0,Chris Callison-Burch,3600,29,141,29,99,0,42,0.8625083333333333,1
MTURK,bdb1e5a4546e1de80f3e8d65ed5a81,39O0SQZVJN7B6KX86CDRP650OKM7RQ,0.83,39.0,Chris Callison-Burch,3600,57,2365,45,2015,12,350,1.3752638888888888,1
MTURK,bdb1e5a4546e1de80f3e8d65ed5a81,3CVDZS288H0XOXZMJNFMRZO7GL6FME,0.83,22.0,Chris Callison-Burch,3600,45,583,45,567,0,16,0.9644138888888889,1
MTURK,bdb1e5a4546e1de80f3e8d65ed5a81,3GS542CVJVNQFGN3O2Y801RARSL59M,0.83,14.0,Chris Callison-Burch,3600,51,322,51,275,0,47,0.9042388888888888,1
MTURK,bdb1e5a4546e1de80f3e8d65ed5a81,36MUZ9VAE622EPTDBJWDQRGDV6ZDEC,0.83,11.0,Chris Callison-Burch,3600,38,443,38,400,0,43,0.932136111111111,1
MTURK,bdb1e5a4546e1de80f3e8d65ed5a81,3APP19WN71E1DUAP7RENKORXR0RG64,0.83,0.0,Chris Callison-Burch,3600,57,571,47,537,10,34,0.9616472222222222,1
MTURK,bdb1e5a4546e1de80f3e8d65ed5a81,3Q2T3FD0ON828LJTZSEKQQZADV23MU,0.83,172.0,Chris Callison-Burch,3600,72,331,41,170,31,161,0.9063138888888889,1
MTURK,bdb1e5a4546e1de80f3e8d65ed5a81,3H4IKZHALBIFU7X3TCDZCJMGN22NNT,0.83,168.0,Chris Callison-Burch,3600,46,507,45,466,1,41,0.9468916666666666,1
MTURK,bdb1e5a4546e1de80f3e8d65ed5a81,31N9JPQXIPINKBBSQEIM7ZPK1QTNHK,0.83,160.0,Chris Callison-Burch,3600,98,800,52,447,46,353,1.0144444444444445,1
MTURK,bdb1e5a4546e1de80f3e8d65ed5a81,31HLTCK4BLVMSKPQ8ZMVWG7W8TIVGA,0.83,157.0,Chris Callison-Burch,3600,40,642,40,585,0,57,0.9780166666666666,1
MTURK,bdb1e5a4546e1de80f3e8d65ed5a81,371Q3BEXDH96R93R4W5F603VKFISZR,0.83,151.0,Chris Callison-Burch,3600,52,669,52,609,0,60,0.9842416666666667,1
MTURK,bdb1e5a4546e1de80f3e8d65ed5a81,3CMIQF80GNQSQJ43ANJZE2VZXN0Q69,0.83,151.0,Chris Callison-Burch,3600,38,390,38,326,0,64,0.9199166666666666,1
MTURK,bdb1e5a4546e1de80f3e8d65ed5a81,3M7OI89LVYOOWIUK55I4UX6IT806CL,0.83,147.0,Chris Callison-Burch,3600,43,158,43,146,0,12,0.8664277777777777,1
MTURK,bdb1e5a4546e1de80f3e8d65ed5a81,3J9UN9O9J3SGQLEBD8J9809M6PN0JS,0.83,143.0,Chris Callison-Burch,3600,38,157,38,30,0,127,0.8661972222222222,1
MTURK,bdb1e5a4546e1de80f3e8d65ed5a81,3K3G488TR28W7F4P549UMWHZ1SQ5Q9,0.83,142.0,Chris Callison-Burch,3600,74,439,42,304,32,135,0.9312138888888888,1
MTURK,bdb1e5a4546e1de80f3e8d65ed5a81,31D0ZWOD0AZ5PSB7J26WF163G2T0AC,0.83,138.0,Chris Callison-Burch,3600,45,411,45,363,0,48,0.9247583333333333,1
MTURK,bdb1e5a4546e1de80f3e8d65ed5a81,3QQUBC64ZEEK61B7VI08ALDEPGCNXD,0.83,134.0,Chris Callison-Burch,3600,86,264,57,125,29,139,0.8908666666666666,1
MTURK,bdb1e5a4546e1de80f3e8d65ed5a81,30U1YOGZGAW3O8YVCEGIF8KSWX8SDS,0.83,133.0,Chris Callison-Burch,3600,30,170,29,123,1,47,0.8691944444444444,1
MTURK,bdb1e5a4546e1de80f3e8d65ed5a81,3VI0PC2ZAYK2OMBJWX0LPADJFQHXO2,0.83,131.0,Chris Callison-Burch,3600,23,178,23,95,0,83,0.8710388888888888,1
MTURK,bdb1e5a4546e1de80f3e8d65ed5a81,3YO4AH2FPDKXC8IO8Y3I51L8KKF0QJ,0.83,128.0,Chris Callison-Burch,3600,50,177,39,96,11,81,0.8708083333333333,1
MTURK,bdb1e5a4546e1de80f3e8d65ed5a81,33TGB4G0LPHI1EGRSEMKJKJ6EYYXTO,0.83,118.0,Chris Callison-Burch,3600,81,643,61,294,20,349,0.9782472222222222,1
MTURK,bdb1e5a4546e1de80f3e8d65ed5a81,3N2YPY1GI6YO86TZ24W7WDMKVD3VET,0.83,116.0,Chris Callison-Burch,3600,45,166,35,27,10,139,0.8682722222222222,1
MTURK,bdb1e5a4546e1de80f3e8d65ed5a81,31ODACBENUFXDH20H0M2F7RRFCXSQX,0.83,110.0,Chris Callison-Burch,3600,167,835,42,137,125,698,1.0225138888888887,1
MTURK,bdb1e5a4546e1de80f3e8d65ed5a81,3E9ZFLPWOYSSS00GY2NG5DHX3HIXI7,0.83,108.0,Chris Callison-Burch,3600,55,199,38,93,17,106,0.8758805555555556,1
MTURK,bdb1e5a4546e1de80f3e8d65ed5a81,3C8QQOM6JP1XS6JRKJKSUJMAW88LI9,0.83,100.0,Chris Callison-Burch,3600,233,1240,41,152,192,1088,1.1158888888888887,1
MTURK,bdb1e5a4546e1de80f3e8d65ed5a81,356ZPKYPUHH99RDUGTZ2XOPIR17PYH,0.83,98.0,Chris Callison-Burch,3600,134,444,57,171,77,273,0.9323666666666666,1
MTURK,bdb1e5a4546e1de80f3e8d65ed5a81,3PGQRAZX02K6MJTM8A3WSTUTELESY0,0.83,87.0,Chris Callison-Burch,3600,134,535,46,139,88,396,0.9533472222222221,1
MTURK,bdb1e5a4546e1de80f3e8d65ed5a81,3M0556243SK36FKMVOUM4ED7LBGNFM,0.83,65.0,Chris Callison-Burch,3600,271,978,79,180,192,798,1.0554833333333333,1
MTURK,bdb1e5a4546e1de80f3e8d65ed5a81,344M16OZKIFB01KQ0DAGMWS79A1NE4,0.83,41.0,Chris Callison-Burch,3600,155,805,52,115,103,690,1.0155972222222223,1
MTURK,bdb1e5a4546e1de80f3e8d65ed5a81,3BFF0DJK8XCA5XUSY4GXKC2EZJWSTB,0.83,11.0,Chris Callison-Burch,3600,501,938,52,140,449,798,1.046261111111111,1
MTURK,bdb1e5a4546e1de80f3e8d65ed5a81,3G5RUKN2EC3U55T9S2UUUIRWIDLN9U,0.83,0.0,Chris Callison-Burch,3600,54,171,33,112,21,59,0.869425,1
MTURK,bdb1e5a4546e1de80f3e8d65ed5a81,3T6EIBTM9LO1Q59PB43P47IGPO4AAC,0.83,272.0,Chris Callison-Burch,3600,5769,33283,2978,20564,2791,12719,8.503580555555555,1
MTURK,bdb1e5a4546e1de80f3e8d65ed5a81,3VLL1PIENQORTHBYXFO6MVTUNQEZO0,0.83,271.0,Chris Callison-Burch,3600,468,2865,112,307,356,2558,1.4905416666666667,0
MTURK,bdb1e5a4546e1de80f3e8d65ed5a81,3RDTX9JRTY152K1MCVD5YL56IYG793,0.83,225.0,Chris Callison-Burch,3600,127,599,47,354,80,245,0.9681027777777778,1
MTURK,bdb1e5a4546e1de80f3e8d65ed5a81,3MNJFORX8B4ZGQEGROY0AXDLUQGF5O,0.83,225.0,Chris Callison-Burch,3600,117,346,49,138,68,208,0.9097722222222222,1
MTURK,bdb1e5a4546e1de80f3e8d65ed5a81,3DTJ4WT8BDF5HQY931LAHJZGJO8ZEW,0.83,224.0,Chris Callison-Burch,3600,136,400,51,187,85,213,0.9222222222222222,1
MTURK,bdb1e5a4546e1de80f3e8d65ed5a81,3SBX2M1TKDNEBW0PRZQKH4BL1WU4Q2,0.83,223.0,Chris Callison-Burch,3600,34,248,34,236,0,12,0.8871777777777777,1
MTURK,bdb1e5a4546e1de80f3e8d65ed5a81,3OJX0UFJ0Z770VDIP36G8DJQQ9E9U8,0.83,222.0,Chris Callison-Burch,3600,47,331,37,312,10,19,0.9063138888888889,1
MTURK,bdb1e5a4546e1de80f3e8d65ed5a81,3WKGUBL7SZM3KZKCZUIO0ICRRQ74LD,0.83,219.0,Chris Callison-Burch,3600,267,471,64,153,203,318,0.9385916666666666,1
MTURK,bdb1e5a4546e1de80f3e8d65ed5a81,3YD0MU1NC21J73BR41R5UGGQOGYA7L,0.83,218.0,Chris Callison-Burch,3600,247,338,44,39,203,299,0.9079277777777778,1
MTURK,bdb1e5a4546e1de80f3e8d65ed5a81,32PT7WK7DMFZ4RDGMZFH70CG4H9D3L,0.83,212.0,Chris Callison-Burch,3600,607,646,105,91,502,555,0.9789388888888888,1
MTURK,bdb1e5a4546e1de80f3e8d65ed5a81,36818Z1KV3D16KA42POFHZ4AJECA3G,0.83,212.0,Chris Callison-Burch,3600,654,1535,122,767,532,768,1.1839027777777777,1
MTURK,bdb1e5a4546e1de80f3e8d65ed5a81,307L9TDWJYSP0OGKNK2VN13RTWU3NV,4.0,1.0,Randy Corpuz,900,8,360,2,35,6,325,5.6,1
MTURK,bdb1e5a4546e1de80f3e8d65ed5a81,3UZUVSO3P7V5IJZQOCVG9H374KREMV,0.83,202.0,Chris Callison-Burch,3600,744,7112,153,310,591,6802,2.469711111111111,1
MTURK,bdb1e5a4546e1de80f3e8d65ed5a81,3M0556243RJC3RXK4Q2QWOJY4I8NFD,0.21,1.0,PickFu,1611,111,452,53,12,58,440,0.26891992551210425,1
MTURK,bdb1e5a4546e1de80f3e8d65ed5a81,38O9DZ0A76CS3KVGZOOSOAACUVJ620,6.0,1.0,Samantha Dubrow,7200,1077,5354,361,1935,716,3419,10.461666666666666,1
MTURK,bdb1e5a4546e1de80f3e8d65ed5a81,3H4IKZHALAHQUIWC81PNQWFJR0UNNR,1.0,1.0,RuRu,3600,110,757,60,9,50,748,1.2102777777777778,1
MTURK,bdb1e5a4546e1de80f3e8d65ed5a81,3P6ENY9P79WV6A01TY5U2RT3FRZHIY,0.83,198.0,Chris Callison-Burch,3600,86,254,27,69,59,185,0.888561111111111,1
MTURK,bdb1e5a4546e1de80f3e8d65ed5a81,34F34TZU7WZNMVHPSVNNRO213N62JD,0.83,194.0,Chris Callison-Burch,3600,367,420,91,206,276,214,0.9268333333333333,1
MTURK,bdb1e5a4546e1de80f3e8d65ed5a81,3ECKRY5B1QWHXV0VZKB12YX8BHFZI5,0.83,192.0,Chris Callison-Burch,3600,159,1093,52,229,107,864,1.0819972222222223,1
MTURK,bdb1e5a4546e1de80f3e8d65ed5a81,31D0ZWOD0AZ5PSB7J26WF163G2SA0L,0.83,187.0,Chris Callison-Burch,3600,201,1692,61,1308,140,384,1.2201,1
MTURK,bdb1e5a4546e1de80f3e8d65ed5a81,36JW4WBR06KBWJYBSQZ9ZUGBZZ7HF7,0.83,185.0,Chris Callison-Burch,3600,255,1245,103,151,152,1094,1.1170416666666667,0
MTURK,bdb1e5a4546e1de80f3e8d65ed5a81,3BPP3MA3TEVLTLB8LC2T9EWVCOQEL3,0.5,36.0,ds-exp,3600,153,337,27,22,126,315,0.5468055555555555,1
MTURK,bdb1e5a4546e1de80f3e8d65ed5a81,3TFJJUELSHP0EHBJI3614KP6D3X2CZ,0.83,178.0,Chris Callison-Burch,3600,413,2960,76,212,337,2748,1.5124444444444443,1
MTURK,bdb1e5a4546e1de80f3e8d65ed5a81,3BC9H1KCYUCZT0AVSFDXPIXEKY9YWK,0.83,178.0,Chris Callison-Burch,3600,215,342,62,235,153,107,0.9088499999999999,1
MTURK,bdb1e5a4546e1de80f3e8d65ed5a81,3126F2F5F83B3MW3GSN8QLX29P2EPR,0.83,157.0,Chris Callison-Burch,3600,43,298,43,286,0,12,0.8987055555555555,1
MTURK,bdb1e5a4546e1de80f3e8d65ed5a81,3YLPJ8OXX8DYKT11DDLCBC7EYZH4XZ,0.83,155.0,Chris Callison-Burch,3600,36,339,36,280,0,59,0.9081583333333333,1
MTURK,bdb1e5a4546e1de80f3e8d65ed5a81,3NSCTNUR2ZN4KZX8G8C8WW2UXA3A56,0.83,154.0,Chris Callison-Burch,3600,34,261,34,216,0,45,0.8901749999999999,1
MTURK,bdb1e5a4546e1de80f3e8d65ed5a81,37OPIVELUU3G0SH3HADHLT5K2JUHAU,0.83,152.0,Chris Callison-Burch,3600,38,852,38,843,0,9,1.0264333333333333,1
MTURK,bdb1e5a4546e1de80f3e8d65ed5a81,3CVBMEMMXBGYHQJ5A71XB23U1BOH73,0.83,141.0,Chris Callison-Burch,3600,40,1382,40,1314,0,68,1.1486277777777778,1
MTURK,bdb1e5a4546e1de80f3e8d65ed5a81,3X7837UUADYB4W0QFXZQH1JDJS86JY,0.83,134.0,Chris Callison-Burch,3600,34,1648,34,1608,0,40,1.2099555555555555,1
MTURK,bdb1e5a4546e1de80f3e8d65ed5a81,3R6RZGK0XFCRL6F3XBQNR0689V0VY7,1.5,1.0,Thomas Meservy,3600,79,954,42,824,37,130,1.8975,1
MTURK,bdb1e5a4546e1de80f3e8d65ed5a81,3VCK0Q0PO5EPM74MH1WZQ6RDFUIN0T,1.71,1.0,Jason Hasbrouck,3600,35,48,19,12,16,36,1.7328,0
MTURK,bdb1e5a4546e1de80f3e8d65ed5a81,3WRAAIUSCNF36I8VQD6MS6G2QX5AXQ,2.42,1.0,Angelica Cooke,3600,42,300,29,152,13,148,2.6216666666666666,1
MTURK,bdb1e5a4546e1de80f3e8d65ed5a81,3ZZAYRN1I6PW4IZULX89QX2IZ99TOF,1.0,1.0,Myungjoo Kim,3600,174,659,81,184,93,475,1.1830555555555555,0
MTURK,bdb1e5a4546e1de80f3e8d65ed5a81,3E22YV8GG1B75BBIHN3WREK82MCNPP,0.6,0.0,Zhongqiang Huang,3600,174,659,81,184,93,475,0.7098333333333333,0
MTURK,bdb1e5a4546e1de80f3e8d65ed5a81,334ZEL5JX79UWMAKFCODLDXVI5GSOK,1.0,1.0,Feng Xu,3600,228,780,97,221,131,559,1.2166666666666668,0
MTURK,bdb1e5a4546e1de80f3e8d65ed5a81,3SZYX62S5G0J2UOG88RMWN8CM3D750,0.25,533.0,SurveyComet,1800,189,674,23,14,166,660,0.3436111111111111,1
MTURK,bdb1e5a4546e1de80f3e8d65ed5a81,3RTFSSG7T86V0K65U24JLHMHQ4CLWJ,1.0,1.0,Brian C. Rathbun,3600,29,255,21,193,8,62,1.0708333333333333,1
MTURK,1c4a09c264cc784a227191d775b213b,3QXFBUZ4ZLGG6J9XCC0PNKJRIOPUGY,2.0,1.0,HCI Lab,7200,195,1670,15,21,180,1649,2.463888888888889,1
MTURK,1c4a09c264cc784a227191d775b213b,38F60IALAGI5BO9S1TUY5BSVZG70TI,0.08,6.0,Panel,7200,191,1680,18,37,173,1643,0.09866666666666667,1
MTURK,1c4a09c264cc784a227191d775b213b,3UQVX1UPFSHRZZDJ3ZKZW5XX2D002V,0.5,1.0,tiffani wang,900,60,383,33,288,27,95,0.7127777777777777,1
MTURK,1c4a09c264cc784a227191d775b213b,3UEDKCTP9V49G3LSK57B0KU3TSUK7S,0.5,0.0,Pelin Constantin,3600,192,3569,85,3179,107,390,0.9956944444444444,0
MTURK,1c4a09c264cc784a227191d775b213b,3S1WOPCJFGYHTFK8GQHAKS30D3CJE2,0.04,121.0,itzik gili,300,3,29,3,29,0,0,0.043866666666666665,1
MTURK,1c4a09c264cc784a227191d775b213b,338431Z1FLKK3UGAI9TFRVJ5RMCOR3,0.04,110.0,itzik gili,300,4,30,4,0,0,30,0.044,1
MTURK,1c4a09c264cc784a227191d775b213b,3DTJ4WT8BDK7TUPCYCKW8MRQW1PEZI,0.04,43.0,itzik gili,300,12,59,6,0,6,59,0.04786666666666667,1
MTURK,1c4a09c264cc784a227191d775b213b,3VIVIU06FKHJASSFF6KTLZT99QEMII,0.04,0.0,itzik gili,300,6,60,5,0,1,60,0.048,1
MTURK,1c4a09c264cc784a227191d775b213b,3A3KKYU7P3M1BNCK4NO8MQ2HO1CWMZ,0.04,3.0,itzik gili,300,6,90,5,0,1,90,0.052000000000000005,1
MTURK,1c4a09c264cc784a227191d775b213b,3XEDXEGFX3TDD9BWQ4I70I19YR2K0G,0.04,1.0,itzik gili,300,6,149,5,0,1,149,0.059866666666666665,1
MTURK,1c4a09c264cc784a227191d775b213b,32ZCLEW0BZPLQ69YP4XLE424RAEJPN,0.04,0.0,itzik gili,300,3,89,3,89,0,0,0.05186666666666667,1
MTURK,1c4a09c264cc784a227191d775b213b,3M67TQBQQHTPXQQNE9OBZFZ6WJ2A93,0.04,0.0,itzik gili,300,5,119,5,89,0,30,0.05586666666666667,1
MTURK,1c4a09c264cc784a227191d775b213b,3UUSLRKAUL8JHE56JMHTBKG6MWB7DQ,0.04,2.0,itzik gili,300,5,120,5,90,0,30,0.056,1
MTURK,1c4a09c264cc784a227191d775b213b,3511RHPADVJCX9DD5HDNZEFBWH7RLP,0.04,2.0,itzik gili,300,5,150,5,90,0,60,0.06,1
MTURK,1c4a09c264cc784a227191d775b213b,3EKZL9T8Y8R65B54WZ8UIRNIFZVCHX,0.04,0.0,itzik gili,300,4,149,4,90,0,59,0.059866666666666665,1
MTURK,1c4a09c264cc784a227191d775b213b,3MXX6RQ9EVAVNOQDMXAH82DL9DO4PH,0.04,0.0,itzik gili,300,4,150,4,150,0,0,0.06,1
MTURK,1c4a09c264cc784a227191d775b213b,3NQUW096N6D6T9HRB0D18TFHQV19LK,0.04,0.0,itzik gili,300,4,240,4,150,0,90,0.07200000000000001,1
MTURK,1c4a09c264cc784a227191d775b213b,3MJ9GGZYO3BEX65OT09WPSRSQDSA2B,0.04,0.0,itzik gili,300,4,269,4,120,0,149,0.07586666666666667,1
MTURK,1c4a09c264cc784a227191d775b213b,3J9L0X0VDFRM43TQFEK3H4WXO259WD,0.04,0.0,itzik gili,300,10,89,3,22,7,67,0.05186666666666667,1
MTURK,1c4a09c264cc784a227191d775b213b,3UV0D2KX1MOJWB1J8UECW8ZH771F4P,0.04,0.0,itzik gili,300,11,119,3,22,8,97,0.05586666666666667,1
MTURK,1c4a09c264cc784a227191d775b213b,3XT3KXP253MZ8D3T4SKUTNQCOJXI6O,0.7,0.0,Raffael Mogicato,1800,2,600,2,600,0,0,0.9333333333333332,1
MTURK,1c4a09c264cc784a227191d775b213b,31JUPBOOROA91W6WOVA8BJJ3GXGL8G,1.5,1.0,kixlab-jean,3600,3,629,3,629,0,0,1.7620833333333334,1
MTURK,1c4a09c264cc784a227191d775b213b,3EN4YVUOVGG8M37VNXEK51IWY2LXJ9,0.7,1.0,Raffael Mogicato,1800,5,30,3,0,2,30,0.7116666666666667,1
MTURK,1c4a09c264cc784a227191d775b213b,35JDMRECC5SHS0NQU5X2I7CRP94EGA,2.0,0.0,Mia Park,3600,490,3479,47,733,443,2746,3.932777777777778,0
MTURK,1c4a09c264cc784a227191d775b213b,3WJGKMRWVI94F53X2LZCG1RQYY4DC0,1.0,15.0,Haemin Joo,3600,137,448,36,82,101,366,1.1244444444444444,1
MTURK,1c4a09c264cc784a227191d775b213b,378G7J1SJM46LRSM5C3AC4W5P88WEB,1.5,1.0,kixlab-jean,3600,69,1469,16,329,53,1140,2.1120833333333335,1
MTURK,1c4a09c264cc784a227191d775b213b,3B6F54KMR2DZMU9OMJTZHTPCBTP1S3,0.02,0.0,p9r,1500,2,60,2,60,0,0,0.0208,1
MTURK,1c4a09c264cc784a227191d775b213b,3P4C70TRMRHH7DCXUJQ2X7ZT5BSGLW,0.07,1647.0,Will Kuffel,3600,200,210,124,99,76,111,0.07408333333333333,0
MTURK,1c4a09c264cc784a227191d775b213b,3IJ95K7NDXC7VDFI6W6HAZ3IA6SGNY,0.07,3866.0,Will Kuffel,3600,237,240,159,115,78,125,0.07466666666666667,0
MTURK,1c4a09c264cc784a227191d775b213b,3PUOXASB573MXS6TVEB1D5O4G759ZH,0.07,3866.0,Will Kuffel,3600,231,210,159,94,72,116,0.07408333333333333,0
MTURK,1c4a09c264cc784a227191d775b213b,3IVEC1GSLPZE88YU9FTMA5IVZX41JF,0.07,3866.0,Will Kuffel,3600,269,240,194,114,75,126,0.07466666666666667,0
MTURK,1c4a09c264cc784a227191d775b213b,37NXA7GVST60PA2SJEPOX823SQGLVQ,0.07,3866.0,Will Kuffel,3600,267,240,192,114,75,126,0.07466666666666667,0
MTURK,1c4a09c264cc784a227191d775b213b,3QMELQS6Y5BQDII4NQEC7SV3HPE6RA,0.07,5147.0,Will Kuffel,3600,327,270,228,116,99,154,0.07525000000000001,0
MTURK,1c4a09c264cc784a227191d775b213b,3PKJ68EHDNWPCJJ8B4W72SY2GM0JHW,0.07,6129.0,Will Kuffel,3600,551,480,374,194,177,286,0.07933333333333334,0
MTURK,1c4a09c264cc784a227191d775b213b,3UOMW19E6D6QOCT70AECQRIHLT0C5U,0.07,5580.0,Will Kuffel,3600,588,510,406,209,182,301,0.07991666666666668,0
MTURK,1c4a09c264cc784a227191d775b213b,3WYZV0QBFJDGGQLBSG1C7Q3JW7ABXW,0.07,5580.0,Will Kuffel,3600,587,510,407,210,180,300,0.07991666666666668,0
MTURK,1c4a09c264cc784a227191d775b213b,3WA2XVDZEMH14EDZ1KUC8LWK20OE65,0.07,1647.0,Will Kuffel,3600,184,180,116,79,68,101,0.07350000000000001,0
MTURK,1c4a09c264cc784a227191d775b213b,3LVTFB9DE5ISYASAMOYYETYNFHFGQL,0.07,5147.0,Will Kuffel,3600,321,270,224,117,97,153,0.07525000000000001,0
MTURK,1c4a09c264cc784a227191d775b213b,3FULMHZ7OUXL1F1YZUPGOVHFFB9M4H,0.07,3866.0,Will Kuffel,3600,261,240,188,115,73,125,0.07466666666666667,0
MTURK,1c4a09c264cc784a227191d775b213b,37M4O367VJI3XY5YDZ8QTNNTF74M5M,0.07,3866.0,Will Kuffel,3600,259,240,186,115,73,125,0.07466666666666667,0
MTURK,1c4a09c264cc784a227191d775b213b,3XH7ZM9YX2UDV1K2LXHOR2M57QM9RO,0.07,5580.0,Will Kuffel,3600,637,510,448,212,189,298,0.07991666666666668,0
MTURK,1c4a09c264cc784a227191d775b213b,33CLA8O0MIBMWBBFOJHG1Y8GAOHRFY,0.07,3866.0,Will Kuffel,3600,215,179,149,93,66,86,0.07348055555555556,0
MTURK,1c4a09c264cc784a227191d775b213b,337F8MIIMZDOY1URAP2IQYA2C8840O,0.07,3866.0,Will Kuffel,3600,215,179,149,93,66,86,0.07348055555555556,0
MTURK,1c4a09c264cc784a227191d775b213b,3VJ4PFXFJ37JGCMOHXQTS8K9K78UAS,0.07,5580.0,Will Kuffel,3600,638,510,448,212,190,298,0.07991666666666668,0
MTURK,1c4a09c264cc784a227191d775b213b,36KM3FWE3RCLHOCACN0PTAUC3AY70B,0.07,5250.0,Will Kuffel,3600,657,507,452,197,205,310,0.07985833333333334,0
MTURK,1c4a09c264cc784a227191d775b213b,3JYPJ2TAYI81KYV0BRDRW38196TFPU,0.07,1632.0,Will Kuffel,3600,1262,1017,889,414,373,603,0.08977500000000001,0
MTURK,1c4a09c264cc784a227191d775b213b,3B9J25CZ25DRUERIC6RKJ2S9ZD8SCC,0.07,6129.0,Will Kuffel,3600,466,387,300,159,166,228,0.07752500000000001,0
MTURK,1c4a09c264cc784a227191d775b213b,344M16OZKIF9BZJR01GTAWI6XQDENF,0.07,4142.0,Will Kuffel,3600,906,717,648,310,258,407,0.08394166666666668,0
MTURK,1c4a09c264cc784a227191d775b213b,3U74KRR67MLB0I1OQW5O9II7000NTE,0.07,5580.0,Will Kuffel,3600,525,420,363,174,162,246,0.07816666666666668,0
MTURK,1c4a09c264cc784a227191d775b213b,3TLFH2L6Y9OFBWCV4D74HUF9P59T2T,0.07,5580.0,Will Kuffel,3600,525,420,362,174,163,246,0.07816666666666668,0
MTURK,1c4a09c264cc784a227191d775b213b,3D4BBDG7ZHWNAX63MRQJBUKX7XAC35,0.07,6129.0,Will Kuffel,3600,328,270,223,186,105,84,0.07525000000000001,1
MTURK,1c4a09c264cc784a227191d775b213b,37Y5RYYI0P5FXC2D32N7XFDJ0VWXSJ,0.07,6129.0,Will Kuffel,3600,327,270,222,186,105,84,0.07525000000000001,1
MTURK,1c4a09c264cc784a227191d775b213b,329E6HTMSW25TVIRE47HZDX5C6JK3Q,0.07,6129.0,Will Kuffel,3600,291,240,189,183,102,57,0.07466666666666667,1
MTURK,1c4a09c264cc784a227191d775b213b,31ANT7FQN82H5K4NM2SD1IFXYL6H59,0.07,3715.0,Will Kuffel,3600,733,569,523,324,210,245,0.0810638888888889,1
MTURK,1c4a09c264cc784a227191d775b213b,3JYPJ2TAYI81KYV0BRDRW38196UPF5,0.07,3715.0,Will Kuffel,3600,668,540,484,226,184,314,0.0805,0
MTURK,1c4a09c264cc784a227191d775b213b,3UV0D2KX1MJFV59HD7L3T5X6IAYF44,0.07,2260.0,Will Kuffel,3600,898,750,651,313,247,437,0.08458333333333334,0
MTURK,1c4a09c264cc784a227191d775b213b,3OZ4VAIBEXFUUKESGTDBHTPBO1CJVN,0.07,1843.0,Will Kuffel,3600,982,810,702,328,280,482,0.08575,0
MTURK,1c4a09c264cc784a227191d775b213b,3W0KKJIARR9RUSOXQL2DQU5GSSBK8I,0.07,1843.0,Will Kuffel,3600,961,780,696,357,265,423,0.08516666666666667,0
MTURK,1c4a09c264cc784a227191d775b213b,3UQ1LLR26A8GXMZU8JYS1LOQ7GGLAQ,0.07,1438.0,Will Kuffel,3600,1019,810,730,360,289,450,0.08575,0
MTURK,1c4a09c264cc784a227191d775b213b,3Y7LTZE0YTMKHKUWTP6S91BITSGUZU,0.07,4142.0,Will Kuffel,3600,488,420,358,229,130,191,0.07816666666666668,1
MTURK,1c4a09c264cc784a227191d775b213b,3AFT28WXLF239PLPXZ6XA0G3FTQIO8,0.07,1365.0,Will Kuffel,3600,1048,840,750,375,298,465,0.08633333333333335,0
MTURK,1c4a09c264cc784a227191d775b213b,335VBRURDJ0OMXFXZRXOSVNMS1X9EC,0.07,4378.0,Will Kuffel,3600,453,359,329,218,124,141,0.07698055555555557,1
MTURK,1c4a09c264cc784a227191d775b213b,3ZLW647WALVACFE1PY1DZHBBV6Y23N,0.07,4378.0,Will Kuffel,3600,356,269,268,265,88,4,0.07523055555555556,1
MTURK,1c4a09c264cc784a227191d775b213b,3LN3BXKGC0VXI7OWYXX46IG93IYGWR,0.07,4824.0,Will Kuffel,3600,283,209,201,162,82,47,0.0740638888888889,1
MTURK,1c4a09c264cc784a227191d775b213b,3MIVREZQVHYX0WOTCFJDCLQGMYXKQT,0.07,4824.0,Will Kuffel,3600,283,209,201,162,82,47,0.0740638888888889,1
MTURK,1c4a09c264cc784a227191d775b213b,3R16PJFTS3RQBR1VEIC09IPBQ6GK4C,0.07,4824.0,Will Kuffel,3600,246,179,169,72,77,107,0.07348055555555556,1
MTURK,1c4a09c264cc784a227191d775b213b,3GL25Y6843UCZHP8J5RLL6ED86FXM8,0.07,5250.0,Will Kuffel,3600,61,32,41,9,20,23,0.07062222222222223,1
MTURK,1c4a09c264cc784a227191d775b213b,37ZQELHEQ0Y7NNB4HZ4CN4NF6S6MNE,0.07,475.0,Will Kuffel,3600,854,690,620,280,234,410,0.08341666666666667,0
MTURK,1c4a09c264cc784a227191d775b213b,3G57RS03HH5DQU153HP6EE9V92P25D,0.07,475.0,Will Kuffel,3600,864,719,616,275,248,444,0.08398055555555556,0
MTURK,1c4a09c264cc784a227191d775b213b,3HRWUH63QU29FGQYP0NQ62CTKXG5N7,0.07,475.0,Will Kuffel,3600,839,689,604,274,235,415,0.08339722222222223,0
MTURK,1c4a09c264cc784a227191d775b213b,31ANT7FQN82H5K4NM2SD1IFXYL85HZ,0.07,475.0,Will Kuffel,3600,817,689,585,288,232,401,0.08339722222222223,0
MTURK,1c4a09c264cc784a227191d775b213b,3UEDKCTP9VQNUEJEGGA7CU9LH867KJ,0.07,2416.0,Will Kuffel,3600,461,390,352,211,109,179,0.07758333333333334,0
MTURK,1c4a09c264cc784a227191d775b213b,3M93N4X8HKNE2SXOMY866654PXJJSJ,0.07,2311.0,Will Kuffel,3600,424,360,328,194,96,166,0.07700000000000001,0
MTURK,1c4a09c264cc784a227191d775b213b,3MGHRFQY2LP4W88BZWQP6NE97990Y7,0.07,2633.0,Will Kuffel,3600,407,329,312,173,95,156,0.07639722222222223,0
MTURK,1c4a09c264cc784a227191d775b213b,3TKXBROM5TAP8EUSHMES24ZHGZIJIS,0.07,2902.0,Will Kuffel,3600,323,240,251,98,72,142,0.07466666666666667,0
MTURK,1c4a09c264cc784a227191d775b213b,356ZPKYPUHH7KPCVGH5FLOFHFHMPY4,0.07,2902.0,Will Kuffel,3600,266,180,197,62,69,118,0.07350000000000001,0
MTURK,1c4a09c264cc784a227191d775b213b,3VMV5CHJZ8F5QQK23SSTJY9AZOGTGE,0.07,3715.0,Will Kuffel,3600,161,90,122,25,39,65,0.07175000000000001,0
MTURK,1c4a09c264cc784a227191d775b213b,3BDORL6HKKDFTZR5XHRFTSNDDBRCRA,0.07,10.0,Will Kuffel,3600,681,569,453,182,228,387,0.0810638888888889,0
MTURK,1c4a09c264cc784a227191d775b213b,3YZ7A3YHR5T6VTI3XW4C5WMZ7WQ5SL,0.07,10.0,Will Kuffel,3600,644,539,433,181,211,358,0.08048055555555556,0
MTURK,1c4a09c264cc784a227191d775b213b,3R5LWXWHR08C77TM82TQ81UGCK5XG2,0.07,0.0,Will Kuffel,3600,831,689,567,254,264,435,0.08339722222222223,0
MTURK,1c4a09c264cc784a227191d775b213b,3L7SUC0TTUU42RJXGT2ECSR2YZWM04,0.07,475.0,Will Kuffel,3600,476,389,338,152,138,237,0.07756388888888889,0
MTURK,1c4a09c264cc784a227191d775b213b,3XU80RHWHZG5XPCSTQPK210FTKS448,0.07,1365.0,Will Kuffel,3600,372,299,251,114,121,185,0.0758138888888889,0
MTURK,1c4a09c264cc784a227191d775b213b,3IVKZBIBJ09IBM2YYY5LUTPPC5HSHP,0.07,847.0,Will Kuffel,3600,337,269,233,174,104,95,0.07523055555555556,0
MTURK,1c4a09c264cc784a227191d775b213b,37M4O367VJI3XY5YDZ8QTNNTF795MA,0.07,826.0,Will Kuffel,3600,312,240,213,167,99,73,0.07466666666666667,0
MTURK,1c4a09c264cc784a227191d775b213b,375VMB7D4JJC5SU07QSHZ644BFMIDE,0.07,826.0,Will Kuffel,3600,312,240,213,167,99,73,0.07466666666666667,0
MTURK,1c4a09c264cc784a227191d775b213b,3WRBLBQ2GR84AHNB5Q4JZN752DM0GC,0.07,826.0,Will Kuffel,3600,312,240,213,167,99,73,0.07466666666666667,0
MTURK,1c4a09c264cc784a227191d775b213b,388FBO7JZRT7H40I02SNHZAMF2KYNG,0.07,2633.0,Will Kuffel,3600,236,170,167,56,69,114,0.07330555555555557,0
MTURK,1c4a09c264cc784a227191d775b213b,3VMV5CHJZ8F5QQK23SSTJY9AZOJGT4,0.07,0.0,Will Kuffel,3600,587,479,388,162,199,317,0.07931388888888889,0
MTURK,1c4a09c264cc784a227191d775b213b,324N5FAHSXBP54KAYEDNI8PO3QGKVR,0.07,0.0,Will Kuffel,3600,546,449,375,195,171,254,0.07873055555555557,0
MTURK,1c4a09c264cc784a227191d775b213b,35NNO802AVWLR4LDWK6KVBGYPJPINX,0.07,0.0,Will Kuffel,3600,516,929,351,260,165,669,0.0880638888888889,1
MTURK,1c4a09c264cc784a227191d775b213b,3URJ6VVYUPN91IMACA4TGZ6KABT4OJ,0.07,0.0,Will Kuffel,3600,516,959,351,260,165,699,0.08864722222222224,1
MTURK,1c4a09c264cc784a227191d775b213b,3K2CEDRACB15I0GOEVQOW3T7VAVMTI,0.07,0.0,Will Kuffel,3600,423,359,297,233,126,126,0.07698055555555557,1
MTURK,1c4a09c264cc784a227191d775b213b,3YGE63DIN8X073DBKV81LQTTW1C0WB,0.07,0.0,Will Kuffel,3600,423,359,297,233,126,126,0.07698055555555557,1
MTURK,1c4a09c264cc784a227191d775b213b,3Y3CZJSZ9KTUUEIQI747FMH3LU95RZ,0.07,0.0,Will Kuffel,3600,383,329,264,221,119,108,0.07639722222222223,1
MTURK,1c4a09c264cc784a227191d775b213b,38LRF35D5LWJWRN38IBJ5063EXKU30,0.07,0.0,Will Kuffel,3600,357,839,233,140,124,699,0.0863138888888889,1
MTURK,1c4a09c264cc784a227191d775b213b,3P520RYKCH6MA6A7M1ZCKX4NSTCU5R,0.07,0.0,Will Kuffel,3600,10,300,5,16,5,284,0.07583333333333334,1
MTURK,1c4a09c264cc784a227191d775b213b,3QXFBUZ4ZKGKQ3ZR3XI3OUVCI2LGUQ,0.07,0.0,Will Kuffel,3600,4,210,4,209,0,1,0.07408333333333333,1
MTURK,1c4a09c264cc784a227191d775b213b,34F34TZU7WZLXTGQSJT0FOS0R3IJ2E,0.07,0.0,Will Kuffel,3600,4,270,4,209,0,61,0.07525000000000001,1
MTURK,1c4a09c264cc784a227191d775b213b,35F6NGNVM8JMXX91APOZDLWH0LVT79,0.07,0.0,Will Kuffel,3600,4,150,4,30,0,120,0.07291666666666667,1
MTURK,1c4a09c264cc784a227191d775b213b,3JTPR5MTZS2D2WJOO29PC9NPZB35KA,0.75,0.0,Richie L. Liu,1500,8,225,3,216,5,9,0.8625,1
MTURK,1c4a09c264cc784a227191d775b213b,3QI9WAYOGQB4EZXFTGACOW6PH4R6SV,0.05,1.0,Anu Bhargava,3600,30,258,22,233,8,25,0.05358333333333334,1
MTURK,1c4a09c264cc784a227191d775b213b,37VE3DA4ZY4LVZQSJZV57H2VN51HBA,0.1,2.0,Sem Foreman,480,62,391,27,75,35,316,0.18145833333333333,1
MTURK,1c4a09c264cc784a227191d775b213b,3JVP4ZJHDPTALRLALOVLZM0FX5P0IJ,0.05,0.0,p9r,1500,20,420,7,159,13,261,0.064,1
MTURK,1c4a09c264cc784a227191d775b213b,3MQY1YVHS3L7UTAIU17IWNPHZDPB25,0.05,0.0,p9r,1500,14,419,7,138,7,281,0.06396666666666667,1
MTURK,1c4a09c264cc784a227191d775b213b,3MQY1YVHS3L7UTAIU17IWNPHZDP2BW,0.05,0.0,p9r,1500,14,389,7,108,7,281,0.06296666666666667,1
MTURK,1c4a09c264cc784a227191d775b213b,33P2GD6NRNTC2MHUJZNIIUE9BQFHKC,0.05,0.0,p9r,1500,12,359,7,106,5,253,0.06196666666666667,1
MTURK,1c4a09c264cc784a227191d775b213b,3Y3CZJSZ9KUM9XAU8HV6U9XX19IR5Y,0.05,0.0,p9r,1500,12,329,7,76,5,253,0.06096666666666667,1
MTURK,1c4a09c264cc784a227191d775b213b,3OND0WXMHWG9GMPKNDCFKZ14RTKEHQ,0.05,0.0,p9r,1500,11,240,7,72,4,168,0.058,1
MTURK,1c4a09c264cc784a227191d775b213b,30P8I9JKOI5S2EYELZYTWJFQOAO5VM,0.08,7956.0,Indeed AggOps,360,138,121,77,38,61,83,0.1068888888888889,0
MTURK,1c4a09c264cc784a227191d775b213b,3M47JKRKCXLQA62FIPXOWB9I97Y68Y,0.08,7780.0,Indeed AggOps,360,184,154,98,44,86,110,0.11422222222222222,0
MTURK,1c4a09c264cc784a227191d775b213b,3X55NP42EO0CJFEEL411BUSOOQW3P9,0.08,9318.0,Indeed AggOps,360,238,212,131,67,107,145,0.12711111111111112,0
MTURK,1c4a09c264cc784a227191d775b213b,3EHIMLB7F7J67VMWE8OST2Y8ILEH8A,0.08,10942.0,Indeed AggOps,360,269,240,150,78,119,162,0.13333333333333333,0
MTURK,1c4a09c264cc784a227191d775b213b,3Z56AA6EK4K5VV4JCQ771TADTCNM62,0.08,11270.0,Indeed AggOps,360,311,270,171,82,140,188,0.14,0
MTURK,1c4a09c264cc784a227191d775b213b,3RWSQDNYL96V8E5DRW6Y093HPAEFFR,0.08,9318.0,Indeed AggOps,360,236,212,129,67,107,145,0.12711111111111112,0
MTURK,1c4a09c264cc784a227191d775b213b,3IH9TRB0FBJOSQDVL5XYE4CF4SNI1K,0.08,7780.0,Indeed AggOps,360,180,154,94,44,86,110,0.11422222222222222,0
MTURK,1c4a09c264cc784a227191d775b213b,3G57RS03HHPJ5N0CXPEIUEIFRCV25B,0.08,9624.0,Indeed AggOps,360,201,180,108,59,93,121,0.12,0
MTURK,1c4a09c264cc784a227191d775b213b,3P4C70TRMR1NM6B4ORFED78DNL0GLW,0.08,7499.0,Indeed AggOps,360,86,90,46,32,40,58,0.1,0
MTURK,1c4a09c264cc784a227191d775b213b,31KPKEKW4AXEYTE7JC1HECPS4AY0BR,0.08,13202.0,Indeed AggOps,360,262,180,165,78,97,102,0.12,0
MTURK,1c4a09c264cc784a227191d775b213b,3KWGG5KP6JMUBCDKMHKANT2NPYYMCU,0.08,13115.0,Indeed AggOps,360,337,253,220,123,117,130,0.13622222222222222,0
MTURK,1c4a09c264cc784a227191d775b213b,3JAOYN9IHLM5CQ9RN64UYRPNJU533Y,0.08,12819.0,Indeed AggOps,360,388,269,252,126,136,143,0.13977777777777778,0
MTURK,1c4a09c264cc784a227191d775b213b,3DGDV62G7OTNYXIVH4NWSKNWICX2PY,0.08,12819.0,Indeed AggOps,360,388,269,252,126,136,143,0.13977777777777778,0
MTURK,1c4a09c264cc784a227191d775b213b,3M67TQBQQH8RBDXSDUKECC6FPW7A9I,0.08,12105.0,Indeed AggOps,360,149,89,91,31,58,58,0.09977777777777778,0
MTURK,1c4a09c264cc784a227191d775b213b,3KVQ0UJWPX55H3YJB93PILY4VJQW5N,0.08,12933.0,Indeed AggOps,360,201,149,126,72,75,77,0.1131111111111111,0
MTURK,1c4a09c264cc784a227191d775b213b,3UV0D2KX1M3LAY8O7FAF956Q0K5F43,0.08,11942.0,Indeed AggOps,360,101,63,60,21,41,42,0.094,0
MTURK,1c4a09c264cc784a227191d775b213b,3RHLQY6EDTOOCEUSG9FPL535O7Q4DI,0.08,11942.0,Indeed AggOps,360,101,63,60,21,41,42,0.094,0
MTURK,1c4a09c264cc784a227191d775b213b,32LAQ1JNT99UA1K4H56M3DJLQ61UTD,0.08,13202.0,Indeed AggOps,360,255,180,158,78,97,102,0.12,0
MTURK,1c4a09c264cc784a227191d775b213b,3BKZLF990ZJYZUCHA29G1TEB2NDYQ1,0.08,13039.0,Indeed AggOps,360,205,168,142,140,63,28,0.11733333333333335,0
MTURK,1c4a09c264cc784a227191d775b213b,3R0WOCG21MTNTCO7VF67Y91ZNKEDUE,0.08,13115.0,Indeed AggOps,360,191,164,131,139,60,25,0.11644444444444445,0
MTURK,1c4a09c264cc784a227191d775b213b,3BO3NEOQM01KMEQVHOQRP55I8MUIA9,0.08,13115.0,Indeed AggOps,360,191,164,131,139,60,25,0.11644444444444445,0
MTURK,1c4a09c264cc784a227191d775b213b,36FQTHX3Z3BAFLD42ZJ0GANZ7MHB3W,0.08,12598.0,Indeed AggOps,360,337,270,214,172,123,98,0.14,0
MTURK,1c4a09c264cc784a227191d775b213b,3G5RUKN2ECNYVWRHMYPJYIQFO36N9F,0.08,12545.0,Indeed AggOps,360,195,161,115,112,80,49,0.11577777777777779,0
MTURK,1c4a09c264cc784a227191d775b213b,3M47JKRKCXLQA62FIPXOWB9I97Z861,0.08,12735.0,Indeed AggOps,360,102,71,57,91,45,-20,0.09577777777777778,0
MTURK,1c4a09c264cc784a227191d775b213b,3IZPORCT1FTCP01SDHUSKJTD8D3HRN,0.08,12638.0,Indeed AggOps,360,165,131,95,109,70,22,0.10911111111111112,0
MTURK,1c4a09c264cc784a227191d775b213b,3B286OTISE1GHPA1Z6BR16KIL1JJAM,0.08,12598.0,Indeed AggOps,360,138,101,78,99,60,2,0.10244444444444445,0
MTURK,1c4a09c264cc784a227191d775b213b,3Y40HMYLL121RITOMF7JSG4R32PXUZ,0.08,12264.0,Indeed AggOps,360,177,152,105,43,72,109,0.11377777777777778,0
MTURK,1c4a09c264cc784a227191d775b213b,3QX22DUVOO1QALJKDYFFDLQCA5FVM3,0.08,11712.0,Indeed AggOps,360,310,271,178,66,132,205,0.14022222222222222,0
MTURK,1c4a09c264cc784a227191d775b213b,3Y40HMYLL121RITOMF7JSG4R32QXU0,0.08,11992.0,Indeed AggOps,360,225,180,129,52,96,128,0.12,0
MTURK,1c4a09c264cc784a227191d775b213b,34O39PNDK6S2YNY6DPKWY8QFD0YRBH,0.08,12264.0,Indeed AggOps,360,161,122,95,38,66,84,0.10711111111111112,0
MTURK,1c4a09c264cc784a227191d775b213b,3SZYX62S5GKQROXI31VDQ5ZN2SI57V,0.08,11463.0,Indeed AggOps,360,328,270,189,74,139,196,0.14,0
MTURK,1c4a09c264cc784a227191d775b213b,3S829FDFT2LFAGI20KHUIG03H2WDX7,0.08,11992.0,Indeed AggOps,360,122,60,67,48,55,12,0.09333333333333334,0
MTURK,1c4a09c264cc784a227191d775b213b,3K8CQCU3KEL97S4PF9ZBC2YQM4RNW5,0.08,11712.0,Indeed AggOps,360,205,151,114,62,91,89,0.11355555555555555,0
MTURK,1c4a09c264cc784a227191d775b213b,37J05LC5AX3EFWDDJG2TR7SO64HDJJ,0.08,11463.0,Indeed AggOps,360,241,180,135,75,106,105,0.12,0
MTURK,1c4a09c264cc784a227191d775b213b,3AXFSPQOYQIBDGR9AMXJF7V9IHXFJW,0.08,11846.0,Indeed AggOps,360,157,90,87,51,70,39,0.1,0
MTURK,1c4a09c264cc784a227191d775b213b,371DNNCG44MWC4DRE25H7L1WTFB8TD,0.08,11712.0,Indeed AggOps,360,203,151,112,62,91,89,0.11355555555555555,0
MTURK,1c4a09c264cc784a227191d775b213b,38G0E1M85MP9NTOTM0614V76NRHUVT,0.08,11161.0,Indeed AggOps,360,162,121,91,24,71,97,0.1068888888888889,0
MTURK,1c4a09c264cc784a227191d775b213b,3LN3BXKGC0F3X0N3S5MGMIPTLS6WG7,0.08,11248.0,Indeed AggOps,360,130,91,69,14,61,77,0.10022222222222223,0
MTURK,1c4a09c264cc784a227191d775b213b,3W9XHF7WGKFG75FSNR2KXQANOF5TKH,0.08,11024.0,Indeed AggOps,360,178,151,98,30,80,121,0.11355555555555555,0
MTURK,1c4a09c264cc784a227191d775b213b,3R16PJFTS3BWQK028Q1CPIYV8GP4KX,0.08,11248.0,Indeed AggOps,360,129,91,68,14,61,77,0.10022222222222223,0
MTURK,1c4a09c264cc784a227191d775b213b,3OQQD2WO8IQK2TRA89BH2XRC2C33IZ,0.08,11024.0,Indeed AggOps,360,140,122,86,29,54,93,0.10711111111111112,0
MTURK,1c4a09c264cc784a227191d775b213b,3TUOHPJXYHHEJMITHFMKA4POOI2WXZ,0.08,10482.0,Indeed AggOps,360,168,200,102,49,66,151,0.12444444444444444,0
MTURK,1c4a09c264cc784a227191d775b213b,31D0ZWOD0AJ9FJ9FDY1LJ15MMSF0AY,0.08,10665.0,Indeed AggOps,360,257,565,147,71,110,494,0.20555555555555555,0
MTURK,1c4a09c264cc784a227191d775b213b,3XBXDSS8883Y8S6UD1FI1T88QBYXL7,0.08,10665.0,Indeed AggOps,360,250,564,140,71,110,493,0.20533333333333337,0
MTURK,1c4a09c264cc784a227191d775b213b,3FW4EL5A3L8R6QHPF6CKW7F372722D,0.08,10665.0,Indeed AggOps,360,250,564,140,71,110,493,0.20533333333333337,0
MTURK,1c4a09c264cc784a227191d775b213b,34F34TZU7WJRCMFXMRICVO1K9DT2J0,0.08,10665.0,Indeed AggOps,360,250,564,140,71,110,493,0.20533333333333337,0
MTURK,1c4a09c264cc784a227191d775b213b,3E24UO25QZATVYPVP6MKTXZIOC4O6L,0.08,10665.0,Indeed AggOps,360,250,564,141,73,109,491,0.20533333333333337,0
MTURK,1c4a09c264cc784a227191d775b213b,35U0MRQMUJREAO4WQEUS5PFH55VVOJ,0.08,10665.0,Indeed AggOps,360,248,564,139,73,109,491,0.20533333333333337,0
MTURK,1c4a09c264cc784a227191d775b213b,3VADEH0UHCHG3WZTBJ22J200G6XSPS,0.08,10665.0,Indeed AggOps,360,251,564,142,73,109,491,0.20533333333333337,0
MTURK,1c4a09c264cc784a227191d775b213b,31MBOZ6PAOBA5UVZM5JVNGNYPT9LCS,0.08,11248.0,Indeed AggOps,360,82,61,48,15,34,46,0.09355555555555556,0
MTURK,1c4a09c264cc784a227191d775b213b,3GVPRXWRPHE23CSXALE7FE3S7EQ7I9,0.08,10665.0,Indeed AggOps,360,247,564,138,73,109,491,0.20533333333333337,0
MTURK,1c4a09c264cc784a227191d775b213b,3ABAOCJ4R8OY5DN3RZL57YR4TD4MQ4,0.08,8195.0,Indeed AggOps,360,9,60,8,27,1,33,0.09333333333333334,1
MTURK,1c4a09c264cc784a227191d775b213b,3KWGG5KP6JMUBCDKMHKANT2NPY3CMP,0.08,7629.0,Indeed AggOps,360,12,120,11,27,1,93,0.10666666666666667,1
MTURK,1c4a09c264cc784a227191d775b213b,3K2CEDRACBLBXTFV83F0C32RDK3TMP,0.08,7977.0,Indeed AggOps,360,8,90,7,27,1,63,0.1,1
MTURK,1c4a09c264cc784a227191d775b213b,31KPKEKW4AXEYTE7JC1HECPS4A2B06,0.08,7977.0,Indeed AggOps,360,8,90,7,27,1,63,0.1,1
MTURK,1c4a09c264cc784a227191d775b213b,3K3G488TR2S0X62XZ04JQWGI7IE5QX,0.08,7977.0,Indeed AggOps,360,8,90,7,27,1,63,0.1,1
MTURK,1c4a09c264cc784a227191d775b213b,3HKIF5DF6YHSL4AVZUCO8YHINRO9GX,0.08,7629.0,Indeed AggOps,360,17,150,16,27,1,123,0.11333333333333334,1
MTURK,1c4a09c264cc784a227191d775b213b,3K8CQCU3KEL97S4PF9ZBC2YQM4TWNG,0.08,7629.0,Indeed AggOps,360,8,120,7,27,1,93,0.10666666666666667,1
MTURK,1c4a09c264cc784a227191d775b213b,37VE3DA4YU1P9TK3HK82K4O9QS5BHB,0.08,6634.0,Indeed AggOps,360,13,149,13,0,0,149,0.1131111111111111,1
MTURK,1c4a09c264cc784a227191d775b213b,374UMBUHN59YO734VELM97XFJ6ZTC7,0.08,6242.0,Indeed AggOps,360,20,179,20,0,0,179,0.11977777777777779,1
MTURK,1c4a09c264cc784a227191d775b213b,3LN50BUKPVVTZJ43RA517GM5ODTLPD,0.08,6242.0,Indeed AggOps,360,20,179,20,0,0,179,0.11977777777777779,1
MTURK,1c4a09c264cc784a227191d775b213b,3OLZC0DJ8JZ4E2TTSJHNLSJVTX0IVH,0.08,6991.0,Indeed AggOps,360,6,89,6,0,0,89,0.09977777777777778,1
MTURK,1c4a09c264cc784a227191d775b213b,3LCXHSGDLTQC65A325MRPQ1W2ZYSEA,0.08,6651.0,Indeed AggOps,360,7,119,7,0,0,119,0.10644444444444445,1
MTURK,1c4a09c264cc784a227191d775b213b,34R0BODSP1JB03CSQ99JWFR4OGRE5X,0.08,6651.0,Indeed AggOps,360,5,119,5,0,0,119,0.10644444444444445,1
MTURK,1c4a09c264cc784a227191d775b213b,3JUDR1D0D6B8Y9JAHH2LSPD6N8NQ2H,0.08,6651.0,Indeed AggOps,360,6,119,6,0,0,119,0.10644444444444445,1
MTURK,1c4a09c264cc784a227191d775b213b,3KL228NDMV6C20TM3R3DY7VYYM2GK2,0.08,6115.0,Indeed AggOps,360,11,60,10,0,1,60,0.09333333333333334,1
MTURK,1c4a09c264cc784a227191d775b213b,3QREJ3J433HSOS7NEI0TBZ06U3OLKD,0.08,5479.0,Indeed AggOps,360,12,120,11,0,1,120,0.10666666666666667,1
MTURK,1c4a09c264cc784a227191d775b213b,3VCK0Q0PO5YGZ234M26Q57PML0I0NO,0.08,5479.0,Indeed AggOps,360,12,120,11,0,1,120,0.10666666666666667,1
MTURK,1c4a09c264cc784a227191d775b213b,3CVBMEMMXB027HHD43WMF22D72EH7V,0.08,5727.0,Indeed AggOps,360,9,89,8,0,1,89,0.09977777777777778,1
MTURK,1c4a09c264cc784a227191d775b213b,35XW21VSVGYQCBKVJR9V2LRGBX0SL0,0.08,5294.0,Indeed AggOps,360,13,179,11,0,2,179,0.11977777777777779,1
MTURK,1c4a09c264cc784a227191d775b213b,3L55D8AUFAHU5T2Y5K8LHOPUY9IYC4,0.08,5294.0,Indeed AggOps,360,11,149,9,0,2,149,0.1131111111111111,1
MTURK,1c4a09c264cc784a227191d775b213b,3XAOZ9UYRZB19O1EYD27N631V3B1QF,0.08,4792.0,Indeed AggOps,360,19,210,17,0,2,210,0.12666666666666668,1
MTURK,1c4a09c264cc784a227191d775b213b,3QGHA0EA0JK76JFSCJU2L7YW5GKBWD,0.08,3800.0,Indeed AggOps,360,12,150,10,0,2,150,0.11333333333333334,1
MTURK,1c4a09c264cc784a227191d775b213b,3F6045TU7D8D6UNNLO6EGHVVJFW99B,0.08,3554.0,Indeed AggOps,360,13,210,10,0,3,210,0.12666666666666668,1
MTURK,1c4a09c264cc784a227191d775b213b,36KM3FWE3RWRWHBH6VP19A3WLLE07E,0.08,3554.0,Indeed AggOps,360,13,239,10,0,3,239,0.13311111111111112,1
MTURK,1c4a09c264cc784a227191d775b213b,37G6BXQPLQ50TPVQA1XMUQMVKCGEQC,0.08,3554.0,Indeed AggOps,360,13,240,10,0,3,240,0.13333333333333333,1
MTURK,1c4a09c264cc784a227191d775b213b,3UQVX1UPFS1KAGEB0J86DJMOA5S02Y,0.08,3212.0,Indeed AggOps,360,14,270,10,0,4,270,0.14,1
MTURK,1c4a09c264cc784a227191d775b213b,3UYRNV2KITJYHR87H6J5YMV44YUN8Y,0.08,4342.0,Indeed AggOps,360,6,120,4,0,2,120,0.10666666666666667,1
MTURK,1c4a09c264cc784a227191d775b213b,385MDVINFCZDO2D40B7JJVH9DLSWJI,0.08,2876.0,Indeed AggOps,360,50,450,17,0,33,450,0.18,1
MTURK,1c4a09c264cc784a227191d775b213b,3CVDZS288HK1EOXUDJABVZNQMCZFM9,0.08,244.0,Indeed AggOps,360,352,240,213,55,139,185,0.13333333333333333,0
MTURK,1c4a09c264cc784a227191d775b213b,30U1YOGZGAG7EZW36AB7J8JB2O0SDM,0.08,1905.0,Indeed AggOps,360,44,29,32,3,12,26,0.08644444444444445,1
MTURK,1c4a09c264cc784a227191d775b213b,3Y7LTZE0YT6QWDT3NXV4P1K2B3WZU9,0.08,1565.0,Indeed AggOps,360,102,61,69,15,33,46,0.09355555555555556,0
MTURK,1c4a09c264cc784a227191d775b213b,3BAWBGQGYLJ7PICX9SDQU3TMFHSV72,0.08,1565.0,Indeed AggOps,360,102,61,69,15,33,46,0.09355555555555556,0
MTURK,1c4a09c264cc784a227191d775b213b,3B6F54KMR2WDM4GRQHRCI6I2DRY1S6,0.08,1565.0,Indeed AggOps,360,133,90,84,22,49,68,0.1,0
MTURK,1c4a09c264cc784a227191d775b213b,3L7SUC0TTUEAHKI4A1RQSS0MGABM0D,0.08,0.0,Indeed AggOps,360,474,330,271,92,203,238,0.15333333333333332,0
MTURK,1c4a09c264cc784a227191d775b213b,3QXFBUZ4ZK0Q5WYYX57F4U4W0D3UGG,0.08,831.0,Indeed AggOps,360,223,149,133,43,90,106,0.1131111111111111,0
MTURK,1c4a09c264cc784a227191d775b213b,3P458N04Q11S76KM3VXDMX9ZKCFX2S,0.08,831.0,Indeed AggOps,360,223,149,133,43,90,106,0.1131111111111111,0
MTURK,1c4a09c264cc784a227191d775b213b,3BPP3MA3TC4P2SFDIWPQD4N1A6VELP,0.08,1565.0,Indeed AggOps,360,89,40,65,15,24,25,0.08888888888888889,0
MTURK,1c4a09c264cc784a227191d775b213b,3BFNCI9LYKAND9AEPI7KB813OX073I,0.08,1206.0,Indeed AggOps,360,154,98,93,29,61,69,0.10177777777777777,0
MTURK,1c4a09c264cc784a227191d775b213b,3B286OTISE1GHPA1Z6BR16KIL2TAJP,0.08,0.0,Indeed AggOps,360,256,180,143,49,113,131,0.12,0
MTURK,1c4a09c264cc784a227191d775b213b,3G9UA71JVVEYYNC3S3Z7RFISKUN7JV,0.08,0.0,Indeed AggOps,360,292,210,157,52,135,158,0.12666666666666668,0
MTURK,1c4a09c264cc784a227191d775b213b,3GL25Y6843EIEAOFDDGX16NXQHXMX9,0.08,244.0,Indeed AggOps,360,182,120,96,20,86,100,0.10666666666666667,0
MTURK,1c4a09c264cc784a227191d775b213b,39KV3A5D18RRXQVTFX8LJG9FGD0S7W,0.08,0.0,Indeed AggOps,360,254,180,141,49,113,131,0.12,0
MTURK,1c4a09c264cc784a227191d775b213b,3T6EIBTM9L85GW7X50YE87HZVFZAA9,0.08,0.0,Indeed AggOps,360,194,137,103,39,91,98,0.11044444444444446,0
MTURK,1c4a09c264cc784a227191d775b213b,3W3RSPVVGSB6ROCZ8W4VHM94WUPULM,0.08,0.0,Indeed AggOps,360,521,361,276,86,245,275,0.1602222222222222,0
MTURK,1c4a09c264cc784a227191d775b213b,3EKTG13IZUNNEG7QZUD9QCSAJ8NMLN,0.08,0.0,Indeed AggOps,360,406,299,222,81,184,218,0.14644444444444443,0
MTURK,1c4a09c264cc784a227191d775b213b,3I6NF2WGIGG9KH8JW4Z7WICG1WBG5L,0.08,0.0,Indeed AggOps,360,366,270,191,74,175,196,0.14,0
MTURK,1c4a09c264cc784a227191d775b213b,3GS542CVJV7U57LBIYTX41QTXJF59I,0.08,0.0,Indeed AggOps,360,366,270,191,74,175,196,0.14,0
MTURK,1c4a09c264cc784a227191d775b213b,3Y40HMYLL121RITOMF7JSG4R330UX9,0.08,0.0,Indeed AggOps,360,235,178,122,51,113,127,0.11955555555555555,0
MTURK,1c4a09c264cc784a227191d775b213b,3XEDXEGFX38FRWI1PPEADF8IR5HK07,0.08,0.0,Indeed AggOps,360,179,149,89,72,90,77,0.1131111111111111,0
MTURK,1c4a09c264cc784a227191d775b213b,3SNR5F7R92DNCR77XTSDLOV9T2YIEC,0.08,0.0,Indeed AggOps,360,496,359,250,108,246,251,0.1597777777777778,0
MTURK,1c4a09c264cc784a227191d775b213b,3MVY4USGB67OMACPYOCIA5ZOUTASIQ,0.08,0.0,Indeed AggOps,360,494,359,248,108,246,251,0.1597777777777778,0
MTURK,1c4a09c264cc784a227191d775b213b,3NI0WFPPI908SHXCNLK93W30QAY06J,0.08,0.0,Indeed AggOps,360,340,240,183,129,157,111,0.13333333333333333,0
MTURK,1c4a09c264cc784a227191d775b213b,32LAQ1JNT99UA1K4H56M3DJLQ7BTUO,0.08,0.0,Indeed AggOps,360,340,240,183,129,157,111,0.13333333333333333,0
MTURK,1c4a09c264cc784a227191d775b213b,31MBOZ6PAOBA5UVZM5JVNGNYPUJLC4,0.08,0.0,Indeed AggOps,360,340,240,183,129,157,111,0.13333333333333333,0
MTURK,1c4a09c264cc784a227191d775b213b,3JHB4BPSFKTJYT492QH02CLKTF39Q0,0.08,0.0,Indeed AggOps,360,452,301,233,134,219,167,0.1468888888888889,0
MTURK,1c4a09c264cc784a227191d775b213b,39WICJI5ATAIGFCESN8MKHVKW9T3ZF,0.87,1.0,Priyanko Guchait,3600,48,780,2,2,46,778,1.0585,1
MTURK,1c4a09c264cc784a227191d775b213b,3I7KR83SOENWQ0ZLJGGE11CFLB5K9G,1.5,1.0,mohammadmilad ameri,1800,58,1546,19,816,39,730,2.788333333333333,1
MTURK,1c4a09c264cc784a227191d775b213b,3K1H3NEY7KY3Z696RBJKBWNMKHNDGA,2.0,0.0,Drew Margolin,420,15,360,2,28,13,332,3.7142857142857144,1
MTURK,1c4a09c264cc784a227191d775b213b,3W0XM68YZRI4X9CZVTHKRF5BKAH1K5,4.0,0.0,Aeshah,3600,69,1380,12,644,57,736,5.533333333333333,1
MTURK,1c4a09c264cc784a227191d775b213b,3VDVA3ILIELB448AEJ4DJHRN6E2G17,1.5,1.0,kixlab-jean,3600,21,920,16,162,5,758,1.8833333333333333,1
MTURK,1c4a09c264cc784a227191d775b213b,3IVKZBIBJ1FPYK2FB81F0IQXBERHSQ,1.5,0.0,kixlab-jean,3600,134,1501,10,99,124,1402,2.1254166666666667,1
MTURK,1c4a09c264cc784a227191d775b213b,3CMV9YRYQ6C3XG0B0FHJ4RQXYAPLJ6,1.0,0.0,Lu Li,3600,26,2191,4,40,22,2151,1.6086111111111112,1
MTURK,1c4a09c264cc784a227191d775b213b,3E22YV8GH5QM39JPZZEZFRSQG2DPN9,3.0,1.0,University of Rochester,7200,15,4289,3,2492,12,1797,4.787083333333333,1
MTURK,1c4a09c264cc784a227191d775b213b,322ZSN9Z5H8MUCQ3EEBQBE6MSP64T1,0.08,1.0,Canva,600,67,145,35,76,32,69,0.09933333333333333,1
MTURK,1c4a09c264cc784a227191d775b213b,31J7RYECZN7NR4ZN34VNZMVLZ67L1Z,2.0,1.0,Canlabresearch01,5400,522,1772,18,7,504,1765,2.656296296296296,1
MTURK,1c4a09c264cc784a227191d775b213b,32LAQ1JNUC8AVT2F5EB6DPB9KH6TUP,0.98,0.0,Ian Church,2700,143,2700,2,1455,141,1245,1.96,1
MTURK,1c4a09c264cc784a227191d775b213b,3LEG2HW4VI6RSCBCRAWBQ21GAIFF2N,0.98,0.0,Ian Church,2700,37,2730,2,261,35,2469,1.9708888888888887,1
MTURK,1c4a09c264cc784a227191d775b213b,34O39PNDL9RIJFGH1YPG8KI37C4BRH,0.98,0.0,Ian Church,2700,359,2610,27,1120,332,1490,1.9273333333333333,0
MTURK,1c4a09c264cc784a227191d775b213b,3DWNFENNE3VXP9WCW96BK3ZZN064JD,0.83,0.0,Chris Callison-Burch,3600,305,1620,85,928,220,692,1.2035,0
MTURK,1c4a09c264cc784a227191d775b213b,39WSF6KUW54DT50LJXA2FXJJZMXEOB,0.98,0.0,Ian Church,2700,119,990,66,834,53,156,1.3393333333333333,0
MTURK,1c4a09c264cc784a227191d775b213b,32TZXEA1OKJ4DVBCE8AZRAF0EK6416,0.5,0.0,Chad Dodson,960,110,479,15,27,95,452,0.7494791666666667,0
MTURK,1c4a09c264cc784a227191d775b213b,3LAZVA75OLLEZX0CUMD5DKMGLVE2O3,6.0,0.0,Tim Miller,7200,3,2250,2,48,1,2202,7.875,1
MTURK,1c4a09c264cc784a227191d775b213b,359AP8GAGGSWIWTEEQ08AYP0E7AC71,1.0,1.0,PROS,3600,2,1920,2,1920,0,0,1.5333333333333332,1
MTURK,1c4a09c264cc784a227191d775b213b,3T8DUCXY0N6ZDWYHIGMAGV829Q9T95,0.9,0.0,Lara Kirfel,7200,2,30,2,30,0,0,0.90375,1
MTURK,1c4a09c264cc784a227191d775b213b,3TD33TP5EO3MJKMNIV8IZCGMKGPBA5,0.05,895.0,Stephen Gilboy,1200,3,30,3,30,0,0,0.051250000000000004,1
MTURK,1c4a09c264cc784a227191d775b213b,3APP19WN84FHNZIV84JKKI5X4AQG60,0.05,883.0,Stephen Gilboy,1200,3,59,3,0,0,59,0.052458333333333336,1
MTURK,1c4a09c264cc784a227191d775b213b,3XBYQ44Z6P41NCA2IXWB51VYTKQWTG,0.07,2192.0,Will Kuffel,3600,55,240,29,64,26,176,0.07466666666666667,1
MTURK,1c4a09c264cc784a227191d775b213b,37G6BXQPLQLUEWWJGT8AEQDB29NEQ5,0.07,2192.0,Will Kuffel,3600,55,240,29,64,26,176,0.07466666666666667,1
MTURK,1c4a09c264cc784a227191d775b213b,3JHB4BPSFK9DJ0528ISOMCC0BC69QP,0.07,2192.0,Will Kuffel,3600,57,270,31,64,26,206,0.07525000000000001,1
MTURK,1c4a09c264cc784a227191d775b213b,38XPGNCKHT04R2V7DMQ7BR0S6C8V4A,0.07,2481.0,Will Kuffel,3600,49,180,23,64,26,116,0.07350000000000001,1
MTURK,1c4a09c264cc784a227191d775b213b,3HRWUH63QU29FGQYP0NQ62CTK51N5Q,0.07,2192.0,Will Kuffel,3600,56,270,30,64,26,206,0.07525000000000001,1
MTURK,1c4a09c264cc784a227191d775b213b,3HXCEECSQMT1YTE13Q3HCMHVPODZYZ,0.07,2481.0,Will Kuffel,3600,49,210,23,64,26,146,0.07408333333333333,1
MTURK,1c4a09c264cc784a227191d775b213b,3G5RUKN2EC3SG3SASQ07IIHV61KN9H,0.07,0.0,Will Kuffel,3600,328,737,162,123,166,614,0.08433055555555556,0
MTURK,1c4a09c264cc784a227191d775b213b,3HUR21WDDUPCTYEM28FWF11KHOFXY0,0.07,0.0,Will Kuffel,3600,322,737,158,123,164,614,0.08433055555555556,0
MTURK,1c4a09c264cc784a227191d775b213b,3ZRKL6Z1E834BQ7NESN39TDOXDNSGP,0.07,0.0,Will Kuffel,3600,377,886,197,148,180,738,0.08722777777777779,0
MTURK,1c4a09c264cc784a227191d775b213b,3R5OYNIC2C9B33D16BIGD7N20NNPTE,0.07,0.0,Will Kuffel,3600,422,916,229,155,193,761,0.08781111111111112,0
MTURK,1c4a09c264cc784a227191d775b213b,3T2EL38U0MK3KWN0BYY22FYIIFXXQW,0.07,0.0,Will Kuffel,3600,577,1066,301,204,276,862,0.09072777777777778,0
MTURK,1c4a09c264cc784a227191d775b213b,3TUOHPJXYHX84TJMN7X8U4G46GFWX0,0.07,0.0,Will Kuffel,3600,319,737,155,123,164,614,0.08433055555555556,0
MTURK,1c4a09c264cc784a227191d775b213b,36KM3FWE3RCLHOCACN0PTAUC3IM078,0.07,0.0,Will Kuffel,3600,328,766,157,123,171,643,0.08489444444444445,0
MTURK,1c4a09c264cc784a227191d775b213b,3PUV2Q8SV442IKGU1G00DJ0RGXLDBZ,0.07,0.0,Will Kuffel,3600,329,796,158,123,171,673,0.08547777777777779,0
MTURK,1c4a09c264cc784a227191d775b213b,3JMNNNO3B1473DGPZICF4EM8T7DW2O,0.07,0.0,Will Kuffel,3600,327,765,158,123,169,642,0.084875,0
MTURK,1c4a09c264cc784a227191d775b213b,375VMB7D4JJC5SU07QSHZ644BN5IDD,0.07,0.0,Will Kuffel,3600,327,765,158,123,169,642,0.084875,0
MTURK,1c4a09c264cc784a227191d775b213b,3AA88CN98P369YFF3P07P7TILF0YKC,0.07,0.0,Will Kuffel,3600,330,795,161,126,169,669,0.08545833333333334,0
MTURK,1c4a09c264cc784a227191d775b213b,30UZJB2POHC2BCXO7H3BXOENFOB35R,0.07,0.0,Will Kuffel,3600,330,795,161,126,169,669,0.08545833333333334,0
MTURK,1c4a09c264cc784a227191d775b213b,3CVDZS288H0VZVYNJBLZFZE6495MF8,0.07,0.0,Will Kuffel,3600,606,1125,296,255,310,870,0.09187500000000001,0
MTURK,1c4a09c264cc784a227191d775b213b,3HY86PZXPYI6XSC2VEIVDP53UXW1EY,0.07,0.0,Will Kuffel,3600,606,1125,296,255,310,870,0.09187500000000001,0
MTURK,1c4a09c264cc784a227191d775b213b,3EHVO81VN5LIH234LFQ1YS2GMDO1HE,0.07,0.0,Will Kuffel,3600,607,1155,297,276,310,879,0.09245833333333334,0
MTURK,1c4a09c264cc784a227191d775b213b,3J9L0X0VDFMI3X1OKRRUE1UMZDOW9H,0.07,0.0,Will Kuffel,3600,607,1126,297,247,310,879,0.09189444444444445,0
MTURK,1c4a09c264cc784a227191d775b213b,3S1WOPCJFGTDS9S6L3O1HP1POEWEJF,0.07,0.0,Will Kuffel,3600,607,1186,297,247,310,939,0.09306111111111112,0
MTURK,1c4a09c264cc784a227191d775b213b,3EAWOID6MTXNSED6UL35ZOAFP0T0V0,0.07,0.0,Will Kuffel,3600,628,1216,314,261,314,955,0.09364444444444445,0
MTURK,1c4a09c264cc784a227191d775b213b,391JB9X4ZY86FHQ1KMCWVC6BC5NMKB,0.07,0.0,Will Kuffel,3600,673,1185,333,255,340,930,0.09304166666666668,0
MTURK,1c4a09c264cc784a227191d775b213b,3RDTX9JRTY13DI0NCJJIMLV56MG79R,0.07,0.0,Will Kuffel,3600,715,1215,367,277,348,938,0.09362500000000001,0
MTURK,1c4a09c264cc784a227191d775b213b,3E9VAUV7BWE0XL6TRYNIVTQMG37YAY,0.07,0.0,Will Kuffel,3600,930,1365,504,383,426,982,0.09654166666666668,0
MTURK,1c4a09c264cc784a227191d775b213b,388CL5C1RJNV7978EP8KI7BUKJTLH4,0.07,0.0,Will Kuffel,3600,737,1185,384,298,353,887,0.09304166666666668,0
MTURK,1c4a09c264cc784a227191d775b213b,3VAOOVPI3ZSXT5QY5ANIAZ41102LLB,0.07,0.0,Will Kuffel,3600,1059,1486,571,425,488,1061,0.09889444444444445,0
MTURK,1c4a09c264cc784a227191d775b213b,37PGLWGSJT6KJY0AZ7E43JZUVW3IKR,0.07,0.0,Will Kuffel,3600,964,1366,522,395,442,971,0.09656111111111113,0
MTURK,1c4a09c264cc784a227191d775b213b,3TZ0XG8CBUK7DW56MOBO0LR0H6O89H,0.07,0.0,Will Kuffel,3600,719,869,410,333,309,536,0.08689722222222224,0
MTURK,1c4a09c264cc784a227191d775b213b,33EEIIWHLAV0DXQRC9PS6SKC483VQ7,5.0,0.0,gerald burch,3600,306,2079,69,164,237,1915,7.8875,1
MTURK,1c4a09c264cc784a227191d775b213b,37Y5RYYI1T7WB24RG75X6GTAGI6SX5,0.3,8.0,Sadia Afroz,3600,66,766,37,691,29,75,0.36383333333333334,1
MTURK,1c4a09c264cc784a227191d775b213b,3CZH926SICEJSBM5OR7UP7H7SDG4E3,0.85,1.0,Dorit Nevo,600,112,507,25,43,87,464,1.56825,1
MTURK,1c4a09c264cc784a227191d775b213b,3WRAAIUSCNF36I8VQD6MS6G2QX5AXQ,2.42,1.0,Angelica Cooke,3600,53,1860,2,287,51,1573,3.6703333333333332,1
MTURK,1c4a09c264cc784a227191d775b213b,38RHULDV9YG3THMVEVO66H9JYHLIWY,0.01,0.0,p9r,1500,13,240,13,209,0,31,0.011600000000000001,1
MTURK,1c4a09c264cc784a227191d775b213b,3QD8LUVX4XZ66TW6HG1YJRJL2XL5X4,0.01,1.0,p9r,1500,11,210,11,209,0,1,0.0114,1
MTURK,1c4a09c264cc784a227191d775b213b,3CESM1J3EI4N0XRUCUFH9EJEPQQ6WS,0.01,0.0,p9r,1500,12,240,12,209,0,31,0.011600000000000001,1
MTURK,1c4a09c264cc784a227191d775b213b,3566S7OX5DKD3WPWYGVOM2TGOO171T,0.01,12.0,p9r,1500,19,300,19,209,0,91,0.012,1
MTURK,1c4a09c264cc784a227191d775b213b,3BFNCI9LYKR9DZ3BLK97AV8DM8F73L,0.01,0.0,p9r,1500,12,210,12,180,0,30,0.0114,1
MTURK,1c4a09c264cc784a227191d775b213b,34OWYT6U3WISHL9NLKEESX180G09IZ,0.01,0.0,p9r,1500,10,90,10,60,0,30,0.0106,1
MTURK,1c4a09c264cc784a227191d775b213b,33NOQL7T9O0EY6FNGWWMSW9NCNJZ8W,0.01,12.0,p9r,1500,12,120,12,60,0,60,0.0108,1
MTURK,1c4a09c264cc784a227191d775b213b,309D674SHZMKSB2KRUWO80Y3BBJCBA,0.01,12.0,p9r,1500,14,120,14,30,0,90,0.0108,1
MTURK,1c4a09c264cc784a227191d775b213b,382GHPVPHSSCUCLSJMB07JO3V6P43Y,0.01,12.0,p9r,1500,11,89,11,30,0,59,0.010593333333333333,1
MTURK,1c4a09c264cc784a227191d775b213b,32204AGAABD700LBT823K2MG4GGHG5,0.01,12.0,p9r,1500,11,59,11,0,0,59,0.010393333333333334,1
MTURK,1c4a09c264cc784a227191d775b213b,3GVPRXWRPHVO32LU6NGUE1A25QC7IL,0.01,12.0,p9r,1500,13,89,13,0,0,89,0.010593333333333333,1
MTURK,1c4a09c264cc784a227191d775b213b,3I4E7AFQ2K07WB27184VVYHK72RTJU,0.01,1.0,p9r,1500,8,59,8,0,0,59,0.010393333333333334,1
MTURK,1c4a09c264cc784a227191d775b213b,3UEBBGULPFP6RMV0IN3KLWBUX9IFU5,0.01,1.0,p9r,1500,15,430,15,428,0,2,0.012866666666666667,1
MTURK,1c4a09c264cc784a227191d775b213b,32PT7WK7DMGPU84LCXCTANI98JID3K,0.01,1.0,p9r,1500,15,430,15,428,0,2,0.012866666666666667,1
MTURK,1c4a09c264cc784a227191d775b213b,3UZUVSO3P7WV80QVEASSC4908MZEMT,0.01,1.0,p9r,1500,15,430,15,428,0,2,0.012866666666666667,1
MTURK,1c4a09c264cc784a227191d775b213b,3W0XM68YZPW1YBWGHAKXQ7Y2U8ZK1A,0.01,2.0,p9r,1500,15,421,15,398,0,23,0.012806666666666668,1
MTURK,1c4a09c264cc784a227191d775b213b,302U8RURJZ2ISTXHL1W2PNMMD7AVNE,0.01,1.0,p9r,1500,23,510,23,398,0,112,0.0134,1
MTURK,1c4a09c264cc784a227191d775b213b,3JTPR5MTZSD0MTXZIXM9TXBJ6O6K5U,0.01,2.0,p9r,1500,14,391,14,368,0,23,0.012606666666666667,1
MTURK,1c4a09c264cc784a227191d775b213b,3ECKRY5B1QX7NCR0PI8D5L31FJPZI5,0.01,0.0,p9r,1500,14,420,14,368,0,52,0.0128,1
MTURK,1c4a09c264cc784a227191d775b213b,3W0KKJIARRAJ9BG1GVTC5HLA8E7K8W,0.01,0.0,p9r,1500,14,370,14,318,0,52,0.012466666666666668,1
MTURK,1c4a09c264cc784a227191d775b213b,3EN4YVUOUCTEDSBR6I5SK12QKYGJX4,0.01,0.0,p9r,1500,14,370,14,318,0,52,0.012466666666666668,1
MTURK,1c4a09c264cc784a227191d775b213b,3O2Y2UIUCQVSOQQOO9ZIF92WVIKKFD,0.01,0.0,p9r,1500,14,360,14,308,0,52,0.0124,1
MTURK,1c4a09c264cc784a227191d775b213b,3J9L0X0VDFNAIGTSA1ITTOAGFRY9W6,0.01,0.0,p9r,1500,15,332,15,249,0,83,0.012213333333333333,1
MTURK,1c4a09c264cc784a227191d775b213b,3CVDZS288H1NEEQR9LCYUMU0KNFMFK,0.01,0.0,p9r,1500,13,332,13,249,0,83,0.012213333333333333,1
MTURK,1c4a09c264cc784a227191d775b213b,3GL25Y6843V4E0HC9FIK0TU7OSBMXB,0.01,1.0,p9r,1500,16,268,16,157,0,111,0.011786666666666668,1
MTURK,1c4a09c264cc784a227191d775b213b,3126F2F5F841T3N86QKKT83VDRBPE1,0.01,0.0,p9r,1500,13,240,13,157,0,83,0.011600000000000001,1
MTURK,1c4a09c264cc784a227191d775b213b,3MXX6RQ9EV5RMIYBRAH85ZBAKSZ4PY,0.07,2556.0,Will Kuffel,3600,25,180,25,178,0,2,0.07350000000000001,1
MTURK,1c4a09c264cc784a227191d775b213b,359AP8GAGGK5BG7QO3T9OBWDCBAC7C,0.07,3216.0,Will Kuffel,3600,27,210,27,178,0,32,0.07408333333333333,1
MTURK,1c4a09c264cc784a227191d775b213b,3QMELQS6Y5BQDII4NQEC7SV3H1T6RD,0.07,3216.0,Will Kuffel,3600,28,240,28,178,0,62,0.07466666666666667,1
MTURK,1c4a09c264cc784a227191d775b213b,32204AGAABCFLHT73YB45F6MO6YHGT,0.07,4788.0,Will Kuffel,3600,29,270,29,178,0,92,0.07525000000000001,1
MTURK,1c4a09c264cc784a227191d775b213b,3RQVKZ7ZRKJSDYFORA43CYNR0KX27T,0.07,4788.0,Will Kuffel,3600,30,300,30,178,0,122,0.07583333333333334,1
MTURK,1c4a09c264cc784a227191d775b213b,3VCK0Q0PO5EAK94XSUHEP7G231IN05,0.07,5405.0,Will Kuffel,3600,31,330,31,178,0,152,0.07641666666666667,1
MTURK,1c4a09c264cc784a227191d775b213b,309D674SHZLSDSAG1K5PTDI9V11CBY,0.07,6601.0,Will Kuffel,3600,31,480,31,148,0,332,0.07933333333333334,1
MTURK,1c4a09c264cc784a227191d775b213b,3J9L0X0VDFMI3X1OKRRUE1UMZHG9WU,0.07,6200.0,Will Kuffel,3600,33,510,33,148,0,362,0.07991666666666668,1
MTURK,1c4a09c264cc784a227191d775b213b,3W31J70BASWT6VEA7XIISG1ZIVACKI,0.07,5670.0,Will Kuffel,3600,34,570,34,148,0,422,0.08108333333333334,1
MTURK,1c4a09c264cc784a227191d775b213b,30Z7M1Q8UYKLIFFBEUPOWG2KNSVA8V,0.07,5670.0,Will Kuffel,3600,34,570,34,148,0,422,0.08108333333333334,1
MTURK,1c4a09c264cc784a227191d775b213b,31MCUE39BKM0R9M8ODM21L5C51GG3L,0.07,5821.0,Will Kuffel,3600,35,601,35,148,0,453,0.08168611111111113,1
MTURK,1c4a09c264cc784a227191d775b213b,379OL9DBSSEMS2WOZS9IZYF2APG9YT,0.07,5417.0,Will Kuffel,3600,37,630,37,148,0,482,0.08225,1
MTURK,1c4a09c264cc784a227191d775b213b,3FJ2RVH25Z6WRH3H672NQUEXVAL295,0.07,4825.0,Will Kuffel,3600,38,750,38,148,0,602,0.08458333333333334,1
MTURK,1c4a09c264cc784a227191d775b213b,33NKDW9FFXIZQVDH6GX7IA91E4OXCR,0.07,4825.0,Will Kuffel,3600,36,750,36,148,0,602,0.08458333333333334,1
MTURK,1c4a09c264cc784a227191d775b213b,3DQYSJDTYLBENTXV27328Y94ZG1XEK,0.07,4451.0,Will Kuffel,3600,39,780,39,148,0,632,0.08516666666666667,1
MTURK,1c4a09c264cc784a227191d775b213b,3SX4X51T809O372RLBEKT2SK2XZAOY,0.07,4451.0,Will Kuffel,3600,39,750,39,119,0,631,0.08458333333333334,1
MTURK,1c4a09c264cc784a227191d775b213b,3B0MCRZMBRUDBBKUPU9W8XM5BOVPPA,0.07,4451.0,Will Kuffel,3600,39,750,39,119,0,631,0.08458333333333334,1
MTURK,1c4a09c264cc784a227191d775b213b,3BFNCI9LYKQHYGB7VAI8V8SJ6YX375,0.07,4144.0,Will Kuffel,3600,41,750,41,90,0,660,0.08458333333333334,1
MTURK,1c4a09c264cc784a227191d775b213b,33NOQL7T9OZMJNNJQM5ND9TTWD28ZU,0.07,3489.0,Will Kuffel,3600,47,870,47,150,0,720,0.08691666666666667,1
MTURK,1c4a09c264cc784a227191d775b213b,3J9UN9O9J3SE1JDCDWPMW0ZLUHDJ0X,0.07,3489.0,Will Kuffel,3600,47,870,47,150,0,720,0.08691666666666667,1
MTURK,1c4a09c264cc784a227191d775b213b,3V0TR1NRVA2KZES92RZBF4MFL6ZA4O,0.07,3157.0,Will Kuffel,3600,48,870,48,120,0,750,0.08691666666666667,1
MTURK,1c4a09c264cc784a227191d775b213b,31KPKEKW4AD8J0F0P4C5YCG8MC40BT,0.07,3157.0,Will Kuffel,3600,48,870,48,120,0,750,0.08691666666666667,1
MTURK,1c4a09c264cc784a227191d775b213b,3A3KKYU7P3HXAHKI90VZJN06ZGNMW6,0.07,2027.0,Will Kuffel,3600,53,1021,53,150,0,871,0.08985277777777778,1
MTURK,1c4a09c264cc784a227191d775b213b,3JHB4BPSFK9DJ0528ISOMCC0BGZQ97,0.07,2444.0,Will Kuffel,3600,49,930,49,150,0,780,0.08808333333333335,1
MTURK,1c4a09c264cc784a227191d775b213b,3BPP3MA3TCKJNZG6OO0EX4EHS7SLEN,0.07,3687.0,Will Kuffel,3600,36,720,36,60,0,660,0.084,1
MTURK,1c4a09c264cc784a227191d775b213b,3W1K7D6QSBH5LLLQTYPX4BJU4JNZBK,0.07,1632.0,Will Kuffel,3600,58,1020,58,120,0,900,0.08983333333333335,1
MTURK,1c4a09c264cc784a227191d775b213b,3ODOP6T3ASKVUBX5PC6W9M3H9I7249,0.07,2027.0,Will Kuffel,3600,48,931,48,120,0,811,0.08810277777777778,1
MTURK,1c4a09c264cc784a227191d775b213b,3VMHWJRYHVG6T7XRXIN8QGU4BHHXF3,0.07,2027.0,Will Kuffel,3600,47,901,47,120,0,781,0.08751944444444446,1
MTURK,1c4a09c264cc784a227191d775b213b,3BKZLF990ZZSK1DAGUK4LT5RKPKQYW,0.07,1632.0,Will Kuffel,3600,48,900,48,120,0,780,0.08750000000000001,1
MTURK,1c4a09c264cc784a227191d775b213b,3T5ZXGO9DEOSPRNFCGMNZ0ETQJOZQW,0.07,1632.0,Will Kuffel,3600,47,870,47,120,0,750,0.08691666666666667,1
MTURK,1c4a09c264cc784a227191d775b213b,3MA5N0ATTCB2KTKFOOIJ4A82ABUKW1,0.07,1632.0,Will Kuffel,3600,48,690,48,120,0,570,0.08341666666666667,1
MTURK,1c4a09c264cc784a227191d775b213b,3AXFSPQOYQY5YNS2GE87Z7MP0J3FJY,0.07,748.0,Will Kuffel,3600,50,780,50,180,0,600,0.08516666666666667,1
MTURK,1c4a09c264cc784a227191d775b213b,39HYCOOPKOLY1BKRS5Q9RZBLS0JMDZ,0.07,416.0,Will Kuffel,3600,50,780,50,180,0,600,0.08516666666666667,1
MTURK,1c4a09c264cc784a227191d775b213b,3PUOXASB573MXS6TVEB1D5O4GJMZ9C,0.07,416.0,Will Kuffel,3600,48,749,48,180,0,569,0.0845638888888889,1
MTURK,1c4a09c264cc784a227191d775b213b,3LCXHSGDLT66RCBW8XXF9QSCK12SEA,0.07,258.0,Will Kuffel,3600,48,778,48,208,0,570,0.08512777777777779,1
MTURK,1c4a09c264cc784a227191d775b213b,3EQPA8A374WB34J2HQ2E2Z27COYZJ7,0.07,258.0,Will Kuffel,3600,48,750,48,180,0,570,0.08458333333333334,1
MTURK,1c4a09c264cc784a227191d775b213b,3XU80RHWHZG5XPCSTQPK210FTW644A,0.07,145.0,Will Kuffel,3600,45,630,45,180,0,450,0.08225,1
MTURK,1c4a09c264cc784a227191d775b213b,3RQVKZ7ZRKJSDYFORA43CYNR0K1722,0.07,0.0,Will Kuffel,3600,45,750,45,180,0,570,0.08458333333333334,1
MTURK,1c4a09c264cc784a227191d775b213b,3SA4EMRVJV2ANUGA89U6TWLX3GMP06,0.07,0.0,Will Kuffel,3600,43,779,43,180,0,599,0.08514722222222224,1
MTURK,1c4a09c264cc784a227191d775b213b,3W1K7D6QSBH5LLLQTYPX4BJU4JQZBN,0.07,0.0,Will Kuffel,3600,43,779,43,180,0,599,0.08514722222222224,1
MTURK,1c4a09c264cc784a227191d775b213b,3BFNCI9LYKQHYGB7VAI8V8SJ6Y1379,0.07,0.0,Will Kuffel,3600,39,720,39,180,0,540,0.084,1
MTURK,1c4a09c264cc784a227191d775b213b,3X7837UUADY9FUZRFL53519C7K26JO,0.07,0.0,Will Kuffel,3600,41,780,41,180,0,600,0.08516666666666667,1
MTURK,1c4a09c264cc784a227191d775b213b,3XU9MCX6VOC2VHZ30O29HFER1WVR2L,0.07,0.0,Will Kuffel,3600,40,690,40,120,0,570,0.08341666666666667,1
MTURK,1c4a09c264cc784a227191d775b213b,37OPIVELUU3EBQG4HYJU9TVJQBOHAK,0.07,0.0,Will Kuffel,3600,40,719,40,120,0,599,0.08398055555555556,1
MTURK,1c4a09c264cc784a227191d775b213b,3ODOP6T3ASKVUBX5PC6W9M3H9IC42G,0.07,0.0,Will Kuffel,3600,43,1049,43,120,0,929,0.09039722222222223,1
MTURK,1c4a09c264cc784a227191d775b213b,3QGHA0EA0J01RQGLIB5Q57PCNHNWBV,0.07,0.0,Will Kuffel,3600,41,1053,41,120,0,933,0.090475,1
MTURK,1c4a09c264cc784a227191d775b213b,32TMVRKDGNY6GQZU5TFXJDGKVI248H,0.07,0.0,Will Kuffel,3600,34,968,34,120,0,848,0.08882222222222223,1
MTURK,1c4a09c264cc784a227191d775b213b,3EKTG13IZU3HZN8J5MOXACJQ19OLMH,0.07,0.0,Will Kuffel,3600,34,907,34,60,0,847,0.08763611111111112,1
MTURK,1c4a09c264cc784a227191d775b213b,3XABXM4AJ15D5VMS3QMAMGHPRAMQ8N,0.07,0.0,Will Kuffel,3600,36,872,36,60,0,812,0.08695555555555556,1
MTURK,1c4a09c264cc784a227191d775b213b,3MWOYZD5WVOVNQWGUFJPF8CK143ON1,0.07,0.0,Will Kuffel,3600,36,904,36,60,0,844,0.08757777777777778,1
MTURK,1c4a09c264cc784a227191d775b213b,3HXK2V1N4KFB6RQPKD8XIB0KZNLG2F,0.07,0.0,Will Kuffel,3600,28,787,28,60,0,727,0.08530277777777778,1
MTURK,1c4a09c264cc784a227191d775b213b,3BPP3MA3TCKJNZG6OO0EX4EHS7WLER,0.07,0.0,Will Kuffel,3600,32,1624,32,60,0,1564,0.1015777777777778,1
MTURK,1c4a09c264cc784a227191d775b213b,3FCO4VKOZ4DK8ER4KUZ4EZWGXNT7E6,0.07,0.0,Will Kuffel,3600,30,1652,30,60,0,1592,0.10212222222222223,1
MTURK,1c4a09c264cc784a227191d775b213b,3WKGUBL7SZM1VXJDZIO1OI2QFI3L4M,0.07,0.0,Will Kuffel,3600,30,1652,30,60,0,1592,0.10212222222222223,1
MTURK,1c4a09c264cc784a227191d775b213b,3CRWSLD91K4P58BGIE4P2TNKWETMOZ,0.07,0.0,Will Kuffel,3600,28,1650,28,60,0,1590,0.10208333333333333,1
MTURK,1c4a09c264cc784a227191d775b213b,3KA7IJSNW65B7HJK6PRVDDHGUKMPBV,0.07,0.0,Will Kuffel,3600,28,1590,28,0,0,1590,0.10091666666666668,1
MTURK,1c4a09c264cc784a227191d775b213b,3X0EMNLXEPPQGVHQB6IVEPBNXC1VP6,0.07,0.0,Will Kuffel,3600,27,1561,27,0,0,1561,0.10035277777777779,1
MTURK,1c4a09c264cc784a227191d775b213b,3D5G8J4N5A4O8NAXSNRFJZCKMFNTVA,0.07,0.0,Will Kuffel,3600,25,1531,25,0,0,1531,0.09976944444444445,1
MTURK,1c4a09c264cc784a227191d775b213b,3L55D8AUFAXY15SPH8TRO1VHLCBCYI,1.0,1.0,Kyle McDonald,360,46,111,26,95,20,16,1.3083333333333333,0
MTURK,1c4a09c264cc784a227191d775b213b,388FBO7JZR23A5JMGNDR3FF5A4EYN0,0.05,0.0,AWS HubSpot Turk Account,1800,49,90,12,21,37,69,0.052500000000000005,0
MTURK,1c4a09c264cc784a227191d775b213b,3ODOP6T3ARJZWEABM6VAWWWLU2W24Z,0.1,0.0,Panos Ipeirotis,3600,27,90,2,0,25,90,0.10250000000000001,1
MTURK,1c4a09c264cc784a227191d775b213b,3TL87MO8CNQOSMD40HJBMGUQ0UDLFW,0.75,0.0,Survey Research,3600,7,870,3,22,4,848,0.93125,1
MTURK,1c4a09c264cc784a227191d775b213b,34F34TZU7X0YW2DS91SRMIN9N13J28,0.75,0.0,Survey Research,3600,6,840,3,3,3,837,0.925,1
MTURK,1c4a09c264cc784a227191d775b213b,3M67TQBQQH8RBDXSDUKECC6FP449AU,0.08,6959.0,Indeed AggOps,360,336,301,212,78,124,223,0.1468888888888889,0
MTURK,1c4a09c264cc784a227191d775b213b,3UQVX1UPFS1KAGEB0J86DJMOACI022,0.08,6957.0,Indeed AggOps,360,380,330,239,86,141,244,0.15333333333333332,0
MTURK,1c4a09c264cc784a227191d775b213b,3O4VWC1GEWQGX4BGQRWHEY6CFZO3JN,0.08,5503.0,Indeed AggOps,360,285,270,168,64,117,206,0.14,0
MTURK,1c4a09c264cc784a227191d775b213b,3Z33IC0JC06B310QOPBA8ZKSAE59VV,0.08,7931.0,Indeed AggOps,360,439,330,294,92,145,238,0.15333333333333332,0
MTURK,1c4a09c264cc784a227191d775b213b,3DA79LNS59FAB77L2LALG4TLD1F3TS,0.08,7931.0,Indeed AggOps,360,439,330,294,92,145,238,0.15333333333333332,0
MTURK,1c4a09c264cc784a227191d775b213b,3TLFH2L6Y98LQPB2YLWGXUOT7NET26,0.08,6957.0,Indeed AggOps,360,367,300,236,84,131,216,0.14666666666666667,0
MTURK,1c4a09c264cc784a227191d775b213b,3IVKZBIBJ0TOQF15S6UXATY9UNJHSO,0.08,6957.0,Indeed AggOps,360,367,300,236,84,131,216,0.14666666666666667,0
MTURK,1c4a09c264cc784a227191d775b213b,3MNJFORX8BO36HCOLKTPEXC40OYF5M,0.08,5503.0,Indeed AggOps,360,265,210,164,60,101,150,0.12666666666666668,0
MTURK,1c4a09c264cc784a227191d775b213b,3511RHPADVYEBWKI429QCBMKP28LRA,0.08,5503.0,Indeed AggOps,360,266,211,165,60,101,151,0.12688888888888888,0
MTURK,1c4a09c264cc784a227191d775b213b,3DFYDSXB2WK0WYOZ5BSI17WCSC8JUB,0.08,5044.0,Indeed AggOps,360,152,121,95,44,57,77,0.1068888888888889,0
MTURK,1c4a09c264cc784a227191d775b213b,3IZPORCT1FTCP01SDHUSKJTD8L0HR0,0.08,5503.0,Indeed AggOps,360,214,181,131,53,83,128,0.12022222222222223,0
MTURK,1c4a09c264cc784a227191d775b213b,3JVP4ZJHDPCOL1SDPMTY0ZT5Z8FI0V,0.08,5044.0,Indeed AggOps,360,145,91,94,35,51,56,0.10022222222222223,0
MTURK,1c4a09c264cc784a227191d775b213b,3QE4DGPGBRVROY4JIZGXRQ621734G5,0.08,10173.0,Indeed AggOps,360,530,359,354,97,176,262,0.1597777777777778,0
MTURK,1c4a09c264cc784a227191d775b213b,3BPP3MA3TC4P2SFDIWPQD4N1ADILEX,0.08,10173.0,Indeed AggOps,360,530,359,354,97,176,262,0.1597777777777778,0
MTURK,1c4a09c264cc784a227191d775b213b,3GS542CVJV7U57LBIYTX41QTXQ359K,0.08,10173.0,Indeed AggOps,360,530,359,354,97,176,262,0.1597777777777778,0
MTURK,1c4a09c264cc784a227191d775b213b,338431Z1FLZMHHNFHUPI4SQEK7FROZ,0.08,11217.0,Indeed AggOps,360,244,149,144,34,100,115,0.1131111111111111,0
MTURK,1c4a09c264cc784a227191d775b213b,3B623HUYJ4AVX40CP20RXG5AR4T8S0,0.08,11217.0,Indeed AggOps,360,244,149,144,34,100,115,0.1131111111111111,0
MTURK,1c4a09c264cc784a227191d775b213b,3DFYDSXB2WK0WYOZ5BSI17WCSC9UJN,0.08,11150.0,Indeed AggOps,360,167,120,105,30,62,90,0.10666666666666667,0
MTURK,1c4a09c264cc784a227191d775b213b,3U74KRR67M5HFB0VK4U0PIRRII6TNY,0.08,11150.0,Indeed AggOps,360,167,120,105,30,62,90,0.10666666666666667,0
MTURK,1c4a09c264cc784a227191d775b213b,30P8I9JKOI5S2EYELZYTWJFQOIMV5Q,0.08,10173.0,Indeed AggOps,360,102,66,70,16,32,50,0.09466666666666668,1
MTURK,1c4a09c264cc784a227191d775b213b,3TD33TP5DLMAZ6CPBEYA3I15D49BA8,0.08,12083.0,Indeed AggOps,360,149,92,85,32,64,60,0.10044444444444445,0
MTURK,1c4a09c264cc784a227191d775b213b,3HO4MYYR128O839SLSYTS3R766PU6H,0.08,12041.0,Indeed AggOps,360,174,120,103,46,71,74,0.10666666666666667,0
MTURK,1c4a09c264cc784a227191d775b213b,3UZUVSO3P7F98AXYI8Q5DH2QAIBEMV,0.08,11844.0,Indeed AggOps,360,224,150,133,54,91,96,0.11333333333333334,0
MTURK,1c4a09c264cc784a227191d775b213b,3NKW03WTLMRUAPHHV1RSGWTVRNCWQF,0.08,11539.0,Indeed AggOps,360,305,210,170,62,135,148,0.12666666666666668,0
MTURK,1c4a09c264cc784a227191d775b213b,360ZO6N6J13SDE6HAXAJL31FJLV9MG,0.08,11844.0,Indeed AggOps,360,223,150,132,54,91,96,0.11333333333333334,0
MTURK,1c4a09c264cc784a227191d775b213b,3ROUCZ907FEJK4VZP28EAXL99KVOON,0.08,12041.0,Indeed AggOps,360,164,91,100,26,64,65,0.10022222222222223,0
MTURK,1c4a09c264cc784a227191d775b213b,3RSBJ6YZECAPERI6QZPON3CVHJ4FOS,0.08,12083.0,Indeed AggOps,360,137,63,80,12,57,51,0.094,0
MTURK,1c4a09c264cc784a227191d775b213b,32LAQ1JNT99UA1K4H56M3DJLQE0UTS,0.08,12041.0,Indeed AggOps,360,164,91,100,26,64,65,0.10022222222222223,0
MTURK,1c4a09c264cc784a227191d775b213b,3OYHVNTV5TI0UDAKRAGL3G40PFMOK4,0.08,10569.0,Indeed AggOps,360,216,209,118,131,98,78,0.12644444444444444,1
MTURK,1c4a09c264cc784a227191d775b213b,3FK4G712NXKDGOFL306WE75B3Y2SSM,0.08,10569.0,Indeed AggOps,360,216,209,118,131,98,78,0.12644444444444444,1
MTURK,1c4a09c264cc784a227191d775b213b,3SMIWMMK61PM2IOYCABXQXQKU8JUWJ,0.08,10796.0,Indeed AggOps,360,167,179,89,128,78,51,0.11977777777777779,1
MTURK,1c4a09c264cc784a227191d775b213b,31KPKEKW4AXEYTE7JC1HECPS4IY0B7,0.08,11395.0,Indeed AggOps,360,93,89,44,91,49,-2,0.09977777777777778,1
MTURK,1c4a09c264cc784a227191d775b213b,3AQN9REUTF04AL8C5G3W1U7CJGPDYS,0.08,10569.0,Indeed AggOps,360,214,209,116,131,98,78,0.12644444444444444,1
MTURK,1c4a09c264cc784a227191d775b213b,3X0EMNLXEP9WVOGX5E77UPK7FIPVPE,0.08,11395.0,Indeed AggOps,360,80,59,41,119,39,-60,0.09311111111111112,1
MTURK,1c4a09c264cc784a227191d775b213b,3T8DUCXY0NQWQ9W1JUBV7HW7DTS9TI,0.08,10796.0,Indeed AggOps,360,84,119,50,37,34,82,0.10644444444444445,1
MTURK,1c4a09c264cc784a227191d775b213b,3N2YPY1GI6ISYXR7W0RW0DL31BNVET,0.08,10282.0,Indeed AggOps,360,247,210,153,65,94,145,0.12666666666666668,0
MTURK,1c4a09c264cc784a227191d775b213b,3X55NP42EO0CJFEEL411BUSOOYX3PQ,0.08,10111.0,Indeed AggOps,360,216,180,134,56,82,124,0.12,0
MTURK,1c4a09c264cc784a227191d775b213b,3QGHA0EA0JK76JFSCJU2L7YW5NCWB4,0.08,10111.0,Indeed AggOps,360,216,180,134,56,82,124,0.12,0
MTURK,1c4a09c264cc784a227191d775b213b,3D4BBDG7ZHGTPQ5AGZFVRUTHPFJ3CD,0.08,9241.0,Indeed AggOps,360,144,151,85,78,59,73,0.11355555555555555,0
MTURK,1c4a09c264cc784a227191d775b213b,3UAU495MIICEX9FWLOKN93DYR6LUO8,0.08,9241.0,Indeed AggOps,360,142,151,83,78,59,73,0.11355555555555555,0
MTURK,1c4a09c264cc784a227191d775b213b,3ZZAYRN1I6BZXW07LJUD47RW8SEOTB,0.08,9241.0,Indeed AggOps,360,199,180,127,90,72,90,0.12,0
MTURK,1c4a09c264cc784a227191d775b213b,3TRB893CSJUO7LM2KXE4U2QCS9WG74,0.08,9112.0,Indeed AggOps,360,233,211,144,116,89,95,0.12688888888888888,1
MTURK,1c4a09c264cc784a227191d775b213b,3BA7SXOG1JAJWP0ZAD0M760E52DR8Y,0.08,9241.0,Indeed AggOps,360,199,180,131,112,68,68,0.12,1
MTURK,1c4a09c264cc784a227191d775b213b,3LVTFB9DE52YD3RHGWNAUT77XZPQGD,0.08,7225.0,Indeed AggOps,360,385,360,231,149,154,211,0.16,0
MTURK,1c4a09c264cc784a227191d775b213b,3V0TR1NRVAMQE7RGWZONV4VZ3CU4AX,0.08,7225.0,Indeed AggOps,360,385,360,231,149,154,211,0.16,0
MTURK,1c4a09c264cc784a227191d775b213b,391FPZIE4C645ST9HBPXPUGXFK8HU8,0.08,7553.0,Indeed AggOps,360,348,330,211,138,137,192,0.15333333333333332,0
MTURK,1c4a09c264cc784a227191d775b213b,31J7RYECZLAQIRL168UB6K47L4JL1J,0.08,7074.0,Indeed AggOps,360,425,390,260,156,165,234,0.16666666666666669,0
MTURK,1c4a09c264cc784a227191d775b213b,3QHITW7OYOTX3CEEUWV0Y7W4Z4CAQL,0.08,7698.0,Indeed AggOps,360,308,271,186,97,122,174,0.14022222222222222,0
MTURK,1c4a09c264cc784a227191d775b213b,3TFJJUELSH94489RCZ1Q8KOPJ1JC2B,0.08,8226.0,Indeed AggOps,360,216,178,131,58,85,120,0.11955555555555555,1
MTURK,1c4a09c264cc784a227191d775b213b,3INZSNUD80AP9K04X4BG2DELA75D94,0.08,8019.0,Indeed AggOps,360,277,240,166,86,111,154,0.13333333333333333,0
MTURK,1c4a09c264cc784a227191d775b213b,3VP28W7DUN41DVWDS80531JZ1NAFZX,0.08,8226.0,Indeed AggOps,360,215,178,130,58,85,120,0.11955555555555555,1
MTURK,1c4a09c264cc784a227191d775b213b,32LAQ1JNT99UA1K4H56M3DJLQE1TUS,0.08,7074.0,Indeed AggOps,360,417,358,256,125,161,233,0.15955555555555556,0
MTURK,1c4a09c264cc784a227191d775b213b,3FO95NVK5CK1F9F8OB6ROX0FHWMSR1,0.08,7074.0,Indeed AggOps,360,208,180,132,161,76,19,0.12,0
MTURK,1c4a09c264cc784a227191d775b213b,39O6Z4JLX2H14XIOR5HOO26AHH1VX5,0.08,6745.0,Indeed AggOps,360,227,209,139,161,88,48,0.12644444444444444,0
MTURK,1c4a09c264cc784a227191d775b213b,3KQC8JMJGCCK6YGQ2RTW2LQX27Q3HO,0.08,6554.0,Indeed AggOps,360,215,208,136,180,79,28,0.12622222222222224,0
MTURK,1c4a09c264cc784a227191d775b213b,3X55NP42EO0CJFEEL411BUSOOYZ3PS,0.08,6038.0,Indeed AggOps,360,218,236,136,180,82,56,0.13244444444444445,0
MTURK,1c4a09c264cc784a227191d775b213b,3X7837UUADIFUNYY9TUFL1IWPQW6J2,0.08,7225.0,Indeed AggOps,360,142,115,87,173,55,-58,0.10555555555555556,0
MTURK,1c4a09c264cc784a227191d775b213b,3UEDKCTP9VAT97ILAOZJSUI5ZQF7K0,0.08,6038.0,Indeed AggOps,360,247,265,146,185,101,80,0.1388888888888889,0
MTURK,1c4a09c264cc784a227191d775b213b,3YOAVL4CA01RFFZO8R4MCXM8CX34Z0,0.08,3776.0,Indeed AggOps,360,450,390,277,82,173,308,0.16666666666666669,0
MTURK,1c4a09c264cc784a227191d775b213b,3L84EBDQ37MH4MP5TIOSWZNR5AGKKK,0.08,4086.0,Indeed AggOps,360,432,327,266,82,166,245,0.15266666666666667,0
MTURK,1c4a09c264cc784a227191d775b213b,3ZURAPD28874IZB5KXRDB7ZNO801FX,0.08,4316.0,Indeed AggOps,360,327,268,192,59,135,209,0.13955555555555554,0
MTURK,1c4a09c264cc784a227191d775b213b,3LCXHSGDLTQC65A325MRPQ1W27YESC,0.08,4316.0,Indeed AggOps,360,327,268,192,59,135,209,0.13955555555555554,0
MTURK,1c4a09c264cc784a227191d775b213b,302OLP89DZRT9B4VPEU5E27NVPECAL,0.08,4678.0,Indeed AggOps,360,258,237,152,47,106,190,0.13266666666666665,1
MTURK,1c4a09c264cc784a227191d775b213b,374UMBUHN59YO734VELM97XFJEYTCM,0.08,5083.0,Indeed AggOps,360,234,208,143,39,91,169,0.12622222222222224,1
MTURK,1c4a09c264cc784a227191d775b213b,3VQTAXTYN35UEFQNHJF13JDZK75UB7,0.08,5557.0,Indeed AggOps,360,158,147,97,23,61,124,0.11266666666666666,1
MTURK,1c4a09c264cc784a227191d775b213b,3ZRKL6Z1E8NAQJ6U80CFPTM8FNDSG7,0.08,4086.0,Indeed AggOps,360,325,240,195,96,130,144,0.13333333333333333,0
MTURK,1c4a09c264cc784a227191d775b213b,3THR0FZ95PDBEJS2CASMIGHFEFVOLB,0.08,4316.0,Indeed AggOps,360,274,210,161,81,113,129,0.12666666666666668,0
MTURK,1c4a09c264cc784a227191d775b213b,3KLL7H3EGDL4I7I9M1Z2LGIGTRKHV0,0.08,4316.0,Indeed AggOps,360,274,210,161,81,113,129,0.12666666666666668,0
MTURK,1c4a09c264cc784a227191d775b213b,3S829FDFT2LFAGI20KHUIG03HATXD4,0.08,5083.0,Indeed AggOps,360,57,61,31,14,26,47,0.09355555555555556,1
MTURK,1c4a09c264cc784a227191d775b213b,3GS542CVJV7U57LBIYTX41QTXRB95Y,0.08,3409.0,Indeed AggOps,360,338,270,198,122,140,148,0.14,0
MTURK,1c4a09c264cc784a227191d775b213b,3CZH926SICYT4K8SC4Q9RNLQOSW4EY,0.08,4086.0,Indeed AggOps,360,293,210,179,116,114,94,0.12666666666666668,0
MTURK,1c4a09c264cc784a227191d775b213b,3KL228NDNZ769B7ZMBF5OZEK9HIKG2,11.75,0.0,Samantha Chiu,4500,675,541,361,158,314,383,13.162611111111111,0
MTURK,1c4a09c264cc784a227191d775b213b,3UEDKCTP9VAT97ILAOZJSUI5ZRJK7J,0.08,3409.0,Indeed AggOps,360,85,59,46,16,39,43,0.09311111111111112,0
MTURK,1c4a09c264cc784a227191d775b213b,3MIVREZQVHI3FPN06N8PSLZ04HAQKM,0.08,2706.0,Indeed AggOps,360,157,119,92,39,65,80,0.10644444444444445,0
MTURK,1c4a09c264cc784a227191d775b213b,3DIIW4IV8PF5KPAE8NG0C2JIGL4I4M,0.08,2706.0,Indeed AggOps,360,157,119,92,39,65,80,0.10644444444444445,0
MTURK,1c4a09c264cc784a227191d775b213b,3OLZC0DJ8JZ4E2TTSJHNLSJVT4YIVT,0.08,2369.0,Indeed AggOps,360,256,179,152,52,104,127,0.11977777777777779,0
MTURK,1c4a09c264cc784a227191d775b213b,3QGTX7BCHPM9BY3OMWNWHPSMCU05ZA,0.08,1704.0,Indeed AggOps,360,327,239,178,64,149,175,0.13311111111111112,0
MTURK,1c4a09c264cc784a227191d775b213b,35F6NGNVM83SCQ884XDBTL51I4A7TC,0.08,1704.0,Indeed AggOps,360,395,270,211,74,184,196,0.14,0
MTURK,1c4a09c264cc784a227191d775b213b,3EKTG13IZUNNEG7QZUD9QCSAJGKML0,0.08,0.0,Indeed AggOps,360,344,361,193,94,151,267,0.1602222222222222,0
MTURK,1c4a09c264cc784a227191d775b213b,33EEIIWHK7RHV0HC5RMWUUAHKFJVQF,0.08,0.0,Indeed AggOps,360,258,274,135,73,123,201,0.1408888888888889,1
MTURK,1c4a09c264cc784a227191d775b213b,3VQTAXTYN35UEFQNHJF13JDZK89BUU,0.08,0.0,Indeed AggOps,360,221,210,114,45,107,165,0.12666666666666668,1
MTURK,1c4a09c264cc784a227191d775b213b,3T2HW4QDUVRF4SUQX8G5I7W3P80C9C,0.08,18.0,Indeed AggOps,360,185,182,100,37,85,145,0.12044444444444445,1
MTURK,1c4a09c264cc784a227191d775b213b,36D1BWBEHNLHDULIPOV4BGT1DGTM2B,0.08,18.0,Indeed AggOps,360,148,122,81,31,67,91,0.10711111111111112,1
MTURK,1c4a09c264cc784a227191d775b213b,3FDWKV9VCN3CXWNH4A7XGMV3UBOUMN,0.03,0.0,p9r,2700,25,29,17,13,8,16,0.030322222222222223,1
MTURK,1c4a09c264cc784a227191d775b213b,3JYPJ2TAYI9TZHN4114QBQOVPTKPFF,0.03,0.0,p9r,2700,25,29,17,13,8,16,0.030322222222222223,1
MTURK,1c4a09c264cc784a227191d775b213b,3RKHNXPHGWXH78NEJYUH193Z56TUKI,0.03,2.0,p9r,2700,108,88,68,21,40,67,0.030977777777777778,0
MTURK,1c4a09c264cc784a227191d775b213b,3LOJFQ4BOXGVQ6CSX34SR9ZBJ6YKDY,0.03,2.0,p9r,2700,108,88,68,21,40,67,0.030977777777777778,0
MTURK,1c4a09c264cc784a227191d775b213b,3J5XXLQDHMCBOP473ICNG9OG8RGV3X,0.1,1.0,p9r,2700,20,90,3,36,17,54,0.10333333333333333,1
MTURK,1c4a09c264cc784a227191d775b213b,3UY4PIS8QRM26HHJENCDIZF6O40N1G,0.1,0.0,p9r,2700,20,90,3,6,17,84,0.10333333333333333,1
MTURK,1c4a09c264cc784a227191d775b213b,3ZXNP4Z39RMQT3T0RQD76H2UMV0L79,0.1,0.0,p9r,2700,36,180,11,101,25,79,0.10666666666666667,0
MTURK,1c4a09c264cc784a227191d775b213b,3BA7SXOG1JR5WFTW6F296T7O37VR8S,0.06,0.0,p9r,2700,79,120,33,21,46,99,0.06266666666666666,0
MTURK,1c4a09c264cc784a227191d775b213b,36MUZ9VAE63S46KI1HTPTEM6Z93ED9,0.06,0.0,p9r,1500,45,29,24,10,21,19,0.06116,0
MTURK,1c4a09c264cc784a227191d775b213b,3BFNCI9LYKR9DZ3BLK97AV8DM9A73I,0.02,20.0,p9r,1500,265,331,54,50,211,281,0.024413333333333335,0
MTURK,1c4a09c264cc784a227191d775b213b,3O71U79SRBQWIJVDF5CX1LDF9E4SM6,0.01,21.0,p9r,1500,32,39,14,18,18,21,0.01026,1
MTURK,1c4a09c264cc784a227191d775b213b,3P4ZBJFX2V4JJQK5DNIL3KWRIQOFW1,0.01,3.0,p9r,1500,46,67,15,17,31,50,0.010446666666666667,1
MTURK,1c4a09c264cc784a227191d775b213b,3SU800BH86T3IBL9W3EEXVF84CMUQB,0.02,0.0,p9r,1500,190,162,51,44,139,118,0.02216,1
MTURK,1c4a09c264cc784a227191d775b213b,37SDSEDIN93H3AUF8LNU02PBZ9281E,0.02,7.0,p9r,1500,233,241,69,30,164,211,0.023213333333333332,0
MTURK,1c4a09c264cc784a227191d775b213b,3VZYA8PITOZY93QVE4CRADWASRV506,0.05,0.0,p9r,1500,264,300,78,43,186,257,0.060000000000000005,0
MTURK,1c4a09c264cc784a227191d775b213b,3ZQX1VYFTD62Z21GENL5CY2JSKCO8H,0.02,0.0,p9r,1500,262,300,76,43,186,257,0.024,0
MTURK,1c4a09c264cc784a227191d775b213b,3BKZLF990Z0KZK5E64B30GLL00XYQD,0.05,0.0,p9r,1500,264,359,77,36,187,323,0.06196666666666667,0
MTURK,1c4a09c264cc784a227191d775b213b,3TFJJUELSHQQ4Y2O813D77VZH62C26,0.05,1.0,p9r,1500,267,419,79,45,188,374,0.06396666666666667,0
MTURK,1c4a09c264cc784a227191d775b213b,3J9L0X0VDFNAIGTSA1ITTOAGFSTW9Q,0.06,0.0,p9r,2700,501,720,177,90,324,630,0.076,0
MTURK,1c4a09c264cc784a227191d775b213b,3UQ1LLR26A98C5RYYTPRG84KN38ALR,0.06,2.0,p9r,1500,47,60,15,13,32,47,0.0624,0
MTURK,1c4a09c264cc784a227191d775b213b,386T3MLZLNWHWL9XC2JUMX61UHX80C,0.06,0.0,p9r,2700,88,301,25,13,63,288,0.06668888888888888,0
MTURK,1c4a09c264cc784a227191d775b213b,3MDWE879UH3IUDVHFAMX6AXV5RCB9Q,0.05,1.0,p9r,1500,58,209,17,0,41,209,0.05696666666666667,0
MTURK,1c4a09c264cc784a227191d775b213b,3QMELQS6Y5CIS1A8D05BMFBXXC6R67,0.05,1.0,p9r,1500,70,300,20,12,50,288,0.060000000000000005,1
MTURK,1c4a09c264cc784a227191d775b213b,3PIOQ99R7YNIFE8HGBMXT1K3Z1ZUNO,0.05,1.0,p9r,1500,70,300,20,12,50,288,0.060000000000000005,1
MTURK,1c4a09c264cc784a227191d775b213b,3CMIQF80GNRIG0V80LGBHP1S1Q46QL,0.05,0.0,p9r,1500,134,180,53,24,81,156,0.056,0
MTURK,1c4a09c264cc784a227191d775b213b,39O0SQZVJN81W1ODWAA3STBTSNRR77,0.06,0.0,p9r,2700,239,300,102,72,137,228,0.06666666666666667,0
MTURK,1c4a09c264cc784a227191d775b213b,3PMR2DOWOO2F8R8WX5ZTMGMN93B54M,0.05,0.0,p9r,1500,167,150,79,30,88,120,0.055,0
MTURK,1c4a09c264cc784a227191d775b213b,3R4QIDVOJPDXWCYIXC49ZW4RZL6EE4,0.05,0.0,p9r,1500,154,91,78,30,76,61,0.053033333333333335,0
MTURK,1c4a09c264cc784a227191d775b213b,3H781YYV6TJZLVGFN7T4YI4S2VTETU,0.1,9.0,p9r,2700,670,788,261,251,409,537,0.12918518518518518,0
MTURK,1c4a09c264cc784a227191d775b213b,3IKDQS3DQE1UFJGQX4O5UN2G620CII,0.08,39.0,p9r,1500,100,36,46,13,54,23,0.08192,0
MTURK,1c4a09c264cc784a227191d775b213b,3CZH926SICFF4A1P86SWQAS0MWCE4Y,0.08,39.0,p9r,1500,100,34,46,12,54,22,0.08181333333333334,0
MTURK,1c4a09c264cc784a227191d775b213b,3UEDKCTP9VRF9XBI6Q16RHPFXVYK78,0.08,10.0,p9r,1500,368,302,157,98,211,204,0.09610666666666667,0
MTURK,1c4a09c264cc784a227191d775b213b,3WJGKMRWVIAD78045QNU3QM3EXQDCF,0.05,0.0,p9r,1500,280,270,119,87,161,183,0.059000000000000004,0
MTURK,1c4a09c264cc784a227191d775b213b,311HQEI8RSHAYSA46R4GEWDS14BZ79,0.08,13.0,p9r,1500,201,180,87,60,114,120,0.0896,0
MTURK,1c4a09c264cc784a227191d775b213b,3ACRLU860NFZP9MYNL2JYOY6WOSBE0,0.05,0.0,p9r,1500,279,270,118,87,161,183,0.059000000000000004,0
MTURK,1c4a09c264cc784a227191d775b213b,309D674SHZMKSB2KRUWO80Y3BCHBC9,0.08,13.0,p9r,1500,179,159,79,58,100,101,0.08848,0
MTURK,1c4a09c264cc784a227191d775b213b,3DZKABX2ZI6Z1P0QWBNO9CSAE4XCVG,0.08,9.0,p9r,1500,75,93,37,46,38,47,0.08496000000000001,0
MTURK,1c4a09c264cc784a227191d775b213b,3JGHED38EDSAT20ZA52X0P4QVA77YQ,0.08,25.0,p9r,1500,276,270,108,80,168,190,0.0944,0
MTURK,1c4a09c264cc784a227191d775b213b,3PEG1BH7AES2B9E8J7DMWJBBGLQBKM,0.1,9.0,p9r,2700,522,697,189,220,333,477,0.12581481481481482,0
MTURK,1c4a09c264cc784a227191d775b213b,3QE4DGPGBRCDOOXGE1IKQDDCZCS4G6,0.1,3.0,p9r,2700,528,750,195,249,333,501,0.12777777777777777,0
MTURK,1c4a09c264cc784a227191d775b213b,375VSR8FVWAKGBUJF52MJD4S2G2ZR5,0.05,0.0,p9r,1500,292,271,112,67,180,204,0.05903333333333334,0
MTURK,1c4a09c264cc784a227191d775b213b,3LCXHSGDLT7Y6V30Y7OEOD860CGES6,0.05,0.0,p9r,1500,503,667,178,221,325,446,0.07223333333333334,0
MTURK,1c4a09c264cc784a227191d775b213b,3NI0WFPPI9HUS7Q9JNMW2JAAOM706I,0.05,0.0,p9r,1500,487,635,175,182,312,453,0.07116666666666667,0
MTURK,1c4a09c264cc784a227191d775b213b,3BFF0DJK8XD0VELXO2D9NZ873M3STA,0.1,3.0,p9r,2700,474,660,178,215,296,445,0.12444444444444445,0
MTURK,1c4a09c264cc784a227191d775b213b,3C8QQOM6JP2NINAWAHH4X6S30BCIL2,0.05,0.0,p9r,1500,476,690,171,201,305,489,0.07300000000000001,0
MTURK,1c4a09c264cc784a227191d775b213b,3ZTE0JGGCET4B5RTVZ1AEKY2IBXOCN,0.05,0.0,p9r,1500,489,720,176,205,313,515,0.07400000000000001,0
MTURK,1c4a09c264cc784a227191d775b213b,3A520CCNWN1U6ZH6H72N3DE0E66EA7,0.05,0.0,p9r,1500,489,720,176,200,313,520,0.07400000000000001,0
MTURK,1c4a09c264cc784a227191d775b213b,3LXX8KJXPWA2D7KQJFRJCUXUCQZ9OW,0.08,0.0,p9r,1500,240,211,94,42,146,169,0.09125333333333334,0
MTURK,1c4a09c264cc784a227191d775b213b,3VLL1PIENQPHJY23NDLIPIZNRTIZOW,0.05,0.0,p9r,1500,488,720,175,205,313,515,0.07400000000000001,0
MTURK,1c4a09c264cc784a227191d775b213b,3RSBJ6YZECRBEHB3M1RBMQJ5FOSFOS,0.08,27.0,p9r,1500,417,678,154,198,263,480,0.11616,0
MTURK,1c4a09c264cc784a227191d775b213b,3GS542CVJVOG5XE8E0VK3OX3VVS59L,0.1,6.0,p9r,2700,487,990,178,209,309,781,0.13666666666666666,0
MTURK,1c4a09c264cc784a227191d775b213b,3ROUCZ907FV5KUOWL4A19KSJ7PGOOK,0.05,3.0,p9r,1500,388,658,144,194,244,464,0.07193333333333334,0
MTURK,1c4a09c264cc784a227191d775b213b,37S0QRNUFBHZEAE076W9FCCJDF888Y,0.05,3.0,p9r,1500,388,658,144,192,244,466,0.07193333333333334,0
MTURK,1c4a09c264cc784a227191d775b213b,30UZJB2POHDUQVPSXRUACBUHV3F531,0.05,3.0,p9r,1500,388,658,144,180,244,478,0.07193333333333334,0
MTURK,1c4a09c264cc784a227191d775b213b,3TD33TP5DL3WZW5M7G0X258FB9UBA5,0.05,0.0,p9r,1500,411,688,152,183,259,505,0.07293333333333334,0
MTURK,1c4a09c264cc784a227191d775b213b,3QE4DGPGBRCDOOXGE1IKQDDCZCPG4F,0.05,0.0,p9r,1500,380,659,143,178,237,481,0.07196666666666668,0
MTURK,1c4a09c264cc784a227191d775b213b,34HEO7RUG6VJF3MB3DMN2KDJTVXARH,0.05,0.0,p9r,1500,380,659,143,193,237,466,0.07196666666666668,0
MTURK,1c4a09c264cc784a227191d775b213b,3GL25Y6843V4E0HC9FIK0TU7OTBXMO,0.05,0.0,p9r,1500,332,569,119,174,213,395,0.06896666666666668,0
MTURK,1c4a09c264cc784a227191d775b213b,3I7SHAD35MXAZLBLR2EM6UHJM0VM7H,0.08,3.0,p9r,1500,360,840,127,189,233,651,0.1248,0
MTURK,1c4a09c264cc784a227191d775b213b,3FULMHZ7OUYDGYT2P4GF3IX9VY44ME,0.1,6.0,p9r,2700,379,899,135,198,244,701,0.1332962962962963,0
MTURK,1c4a09c264cc784a227191d775b213b,3P520RYKCH7EPP2BCBQBZKKH8GZ5U9,0.08,0.0,p9r,1500,362,929,125,188,237,741,0.12954666666666667,0
MTURK,1c4a09c264cc784a227191d775b213b,3ICOHX7ENCCY5MJOP55UE72N5K00E8,0.1,3.0,p9r,2700,350,869,120,180,230,689,0.13218518518518518,0
MTURK,1c4a09c264cc784a227191d775b213b,338431Z1FLG8H7GCDWR53FXOIC1ROX,0.08,0.0,p9r,1500,284,698,95,161,189,537,0.11722666666666667,0
MTURK,1c4a09c264cc784a227191d775b213b,3Y7LTZE0YTNCW3M0JZXROORC9F6ZU9,0.05,2.0,p9r,1500,119,420,45,396,74,24,0.064,0
MTURK,1c4a09c264cc784a227191d775b213b,309D674SHZMKSB2KRUWO80Y3BCEBC6,0.05,2.0,p9r,1500,117,420,43,396,74,24,0.064,0
MTURK,1c4a09c264cc784a227191d775b213b,3ZVPAMTJWN4KPUZEPDEXY6OMRQ9GRY,0.05,2.0,p9r,1500,118,420,44,396,74,24,0.064,0
MTURK,1c4a09c264cc784a227191d775b213b,33NOQL7T9O0EY6FNGWWMSW9NCOF8Z3,0.05,1.0,p9r,1500,123,419,44,397,79,22,0.06396666666666667,0
MTURK,1c4a09c264cc784a227191d775b213b,341H3G5YF0FWGHAKLSJ7ZH35TQ40Z9,0.05,1.0,p9r,1500,123,419,44,397,79,22,0.06396666666666667,0
MTURK,1c4a09c264cc784a227191d775b213b,38DCH97KHH3U4VAFK4A0QT6XNWOQJB,0.05,1.0,p9r,1500,123,419,44,397,79,22,0.06396666666666667,0
MTURK,1c4a09c264cc784a227191d775b213b,372AGES0I46VBGU4ENE1MSOHUG9RX5,0.1,0.0,p9r,2700,76,240,16,9,60,231,0.1088888888888889,1
MTURK,1c4a09c264cc784a227191d775b213b,375VMB7D4JK4KBM4X0JGETKYR2GDIN,0.06,0.0,p9r,2700,61,179,16,0,45,179,0.06397777777777777,1
MTURK,1c4a09c264cc784a227191d775b213b,30Y6N4AHYPXHDAPNNNDPSLLPEYURD0,0.1,0.0,p9r,2700,157,390,40,50,117,340,0.11444444444444445,0
MTURK,1c4a09c264cc784a227191d775b213b,3BFF0DJK8XD0VELXO2D9NZ873MZTS7,0.05,4.0,p9r,2700,132,330,41,78,91,252,0.05611111111111111,0
MTURK,1c4a09c264cc784a227191d775b213b,3S4TINXCC0OL10ZNHZ5F30SK0RLOB6,0.05,0.0,p9r,2700,134,359,42,78,92,281,0.05664814814814815,0
MTURK,1c4a09c264cc784a227191d775b213b,3LCXHSGDLT7Y6V30Y7OEOD860D1SE7,0.05,1.0,p9r,2700,71,119,32,50,39,69,0.052203703703703704,0
MTURK,1c4a09c264cc784a227191d775b213b,3VEI3XUCZRYQ27SDSW4KSF2ESIKPR1,0.05,0.0,p9r,2700,72,149,32,50,40,99,0.05275925925925926,0
MTURK,1c4a09c264cc784a227191d775b213b,3O71U79SRBQWIJVDF5CX1LDF9FSSMW,0.05,0.0,p9r,2700,130,359,38,78,92,281,0.05664814814814815,0
MTURK,1c4a09c264cc784a227191d775b213b,3SMIWMMK616828HV8CDKPKXUSERUW5,0.05,0.0,p9r,2700,131,359,39,78,92,281,0.05664814814814815,0
MTURK,1c4a09c264cc784a227191d775b213b,3XEIP58NL0O9DDZ6AL5QX1VTWP2LZS,0.05,0.0,p9r,2700,131,359,39,78,92,281,0.05664814814814815,0
MTURK,1c4a09c264cc784a227191d775b213b,3K3G488TR29MXWVUV266PJNS5WI5QV,0.05,3.0,p9r,2700,133,390,41,78,92,312,0.05722222222222222,0
MTURK,1c4a09c264cc784a227191d775b213b,33KGGVH24UI7IBVNGTZMG164QIB1XF,0.05,3.0,p9r,2700,131,390,39,78,92,312,0.05722222222222222,0
MTURK,1c4a09c264cc784a227191d775b213b,3VP28W7DUNLNDLPAOA2S2OQ9ZSRZFA,0.05,2.0,p9r,2700,135,419,40,78,95,341,0.05775925925925926,0
MTURK,1c4a09c264cc784a227191d775b213b,3LG268AV387M5G3NJIO9Y33AEBJREJ,0.05,2.0,p9r,2700,135,419,40,78,95,341,0.05775925925925926,0
MTURK,1c4a09c264cc784a227191d775b213b,34HEO7RUG6VJF3MB3DMN2KDJTWLRAO,0.05,2.0,p9r,2700,135,419,40,78,95,341,0.05775925925925926,0
MTURK,1c4a09c264cc784a227191d775b213b,31ODACBENUGN3YT57YJEIUXKJGPSQJ,0.05,1.0,p9r,2700,134,510,40,61,94,449,0.059444444444444446,0
MTURK,1c4a09c264cc784a227191d775b213b,3WJGKMRWVIAD78045QNU3QM3EYEDC5,0.05,2.0,p9r,2700,142,540,40,61,102,479,0.060000000000000005,0
MTURK,1c4a09c264cc784a227191d775b213b,36QZ6V1589EFVR0MO73JSVU9M1VSUO,0.05,2.0,p9r,2700,142,540,40,61,102,479,0.060000000000000005,0
MTURK,1c4a09c264cc784a227191d775b213b,3L55D8AUFAYG5JVV1MA8GBW4WMKCYC,0.04,0.0,p9r,2700,150,780,42,81,108,699,0.051555555555555556,0
MTURK,1c4a09c264cc784a227191d775b213b,3B9XR6P1WEW70P8Q1MDAV4BY1X9JBG,0.01,126.0,p9r,1500,22,36,7,4,15,32,0.01024,1
MTURK,1c4a09c264cc784a227191d775b213b,335VBRURDJ1G1G71P1ON7I3G8PHE9N,0.06,1.0,p9r,2700,93,689,23,68,70,621,0.0753111111111111,1
MTURK,1c4a09c264cc784a227191d775b213b,337F8MIIMZEGDKMV0ZTH5LQWSV004W,0.04,0.0,p9r,2700,86,690,22,48,64,642,0.050222222222222224,1
MTURK,1c4a09c264cc784a227191d775b213b,3WPCIUYH1A9UTP2FRCIKS0M72JTDT1,0.1,0.0,p9r,2700,71,630,22,29,49,601,0.12333333333333334,1
MTURK,1c4a09c264cc784a227191d775b213b,38RHULDV9YG3THMVEVO66H9JYIGWI9,0.1,0.0,p9r,2700,43,599,22,20,21,579,0.12218518518518519,1
MTURK,1c4a09c264cc784a227191d775b213b,3KG2UQJ0MJPQNL10Z22SJ0NEWGVNQE,0.1,0.0,p9r,2700,37,539,17,20,20,519,0.11996296296296297,1
MTURK,1c4a09c264cc784a227191d775b213b,3JHB4BPSFKA5YJX6YSJN1ZSURRD9Q0,0.1,0.0,p9r,2700,16,210,9,20,7,190,0.10777777777777778,1
MTURK,1c4a09c264cc784a227191d775b213b,3FI30CQHVKKVCUTJH3JLM06TFRWB69,0.06,0.0,p9r,2700,11,149,9,0,2,149,0.06331111111111111,1
MTURK,1c4a09c264cc784a227191d775b213b,30QQTY5GMKLTCTGU0458X4YDZMVU7E,0.1,0.0,p9r,2700,4,240,4,240,0,0,0.1088888888888889,1
MTURK,1c4a09c264cc784a227191d775b213b,3IVKZBIBJ0AAQ5U2O8WK9G5JSS6SHY,0.1,0.0,p9r,2700,5,240,5,210,0,30,0.1088888888888889,1
MTURK,1c4a09c264cc784a227191d775b213b,3D4BBDG7ZHXFPGY7C1HIQH0RNLV3C3,0.04,0.0,p9r,2700,5,120,5,90,0,30,0.04177777777777778,1
MTURK,1c4a09c264cc784a227191d775b213b,3VO4XFFP15N1K09DJVL3N31OW1T7QQ,0.1,0.0,p9r,2700,21,120,7,34,14,86,0.10444444444444445,1
MTURK,1c4a09c264cc784a227191d775b213b,3GMLHYZ0LEYCRDCVNDV8AHIA3L4YUJ,0.1,0.0,p9r,2700,19,90,5,34,14,56,0.10333333333333333,1
MTURK,1c4a09c264cc784a227191d775b213b,31N9JPQXIPJDAS2XGCFYAMVD5UQNHB,0.06,0.0,p9r,2700,28,90,6,5,22,85,0.062,1
MTURK,1c4a09c264cc784a227191d775b213b,3EAWOID6MTYF7X5AKVU4EBQ95FWV02,0.1,0.0,p9r,2700,14,29,6,0,8,29,0.10107407407407408,1
MTURK,1c4a09c264cc784a227191d775b213b,3QE4DGPGBRCDOOXGE1IKQDDCZCVG4L,0.1,0.0,p9r,2700,128,181,15,1,113,180,0.1067037037037037,1
MTURK,1c4a09c264cc784a227191d775b213b,3N5YJ55YXG4Y05UJA656T089SY8ANT,0.1,2.0,p9r,2700,47,60,7,0,40,60,0.10222222222222223,1
MTURK,1c4a09c264cc784a227191d775b213b,344M16OZKIG1QIBVQB7SPJY0DD6ENS,0.1,2.0,p9r,2700,48,60,8,0,40,60,0.10222222222222223,1
MTURK,1c4a09c264cc784a227191d775b213b,37VUR2VJ6AQJFDKSPX3Z2OLUP0Q1CG,0.1,2.0,p9r,2700,57,90,8,0,49,90,0.10333333333333333,1
MTURK,1c4a09c264cc784a227191d775b213b,3THR0FZ95PUXE9LZ8CU9H3OPCKHLO6,0.1,12.0,p9r,2700,110,149,14,2,96,147,0.10551851851851853,1
MTURK,1c4a09c264cc784a227191d775b213b,3J94SKDEKIQS8NRPQG0MPKGTMG55D0,0.1,12.0,p9r,2700,101,120,12,2,89,118,0.10444444444444445,1
MTURK,1c4a09c264cc784a227191d775b213b,31KPKEKW4AE0YJ74FE34DZW22NNB0J,0.1,6.0,p9r,2700,101,150,16,10,85,140,0.10555555555555556,1
MTURK,1c4a09c264cc784a227191d775b213b,3PGQRAZX02LWC0KRY808VG0MIOOSY2,0.1,0.0,p9r,2700,92,150,17,4,75,146,0.10555555555555556,1
MTURK,1c4a09c264cc784a227191d775b213b,375VSR8FVWAKGBUJF52MJD4S2G5RZ0,0.1,0.0,p9r,2700,92,150,17,4,75,146,0.10555555555555556,1
MTURK,1c4a09c264cc784a227191d775b213b,3M0556243SLTWWBRLMRY71J0PELNFJ,0.1,2.0,p9r,2700,123,301,21,4,102,297,0.11114814814814815,1
MTURK,1c4a09c264cc784a227191d775b213b,33J5JKFMK6ZJJH8QHJIDAMP8RZ73QH,0.1,1.0,p9r,2700,113,180,16,5,97,175,0.10666666666666667,1
MTURK,1c4a09c264cc784a227191d775b213b,3E6L1VR4XWNLPB5ZM55H5QXEUOY6FU,0.1,0.0,p9r,2700,99,210,18,3,81,207,0.10777777777777778,1
MTURK,1c4a09c264cc784a227191d775b213b,360ZO6N6J1KED4ZE6ZC6KQ8PHQI9MF,0.1,0.0,p9r,2700,81,269,19,3,62,266,0.10996296296296297,1
MTURK,1c4a09c264cc784a227191d775b213b,3XDJY5RK5SMWT6YBY671USE38LY4UZ,0.06,0.0,p9r,2700,77,240,16,2,61,238,0.06533333333333333,1
MTURK,1c4a09c264cc784a227191d775b213b,3BC9H1KCYUDPJH10IDA9S537O1FYWI,0.1,0.0,p9r,2700,77,240,16,2,61,238,0.1088888888888889,1
MTURK,1c4a09c264cc784a227191d775b213b,3HJ1EVZS2OKJVINQUY7DFCZDNL63RF,0.1,0.0,p9r,2700,70,209,14,0,56,209,0.10774074074074075,1
MTURK,1c4a09c264cc784a227191d775b213b,3NBFJK3IOHJHSH7YXLXT4BJHG3ROGZ,0.1,0.0,p9r,2700,46,179,14,0,32,179,0.10662962962962963,1
MTURK,1c4a09c264cc784a227191d775b213b,3CIS7GGG65KEL8V4NCJE3EQUL94UE5,0.1,0.0,p9r,2700,19,149,9,47,10,102,0.10551851851851853,1
MTURK,1c4a09c264cc784a227191d775b213b,3LVTFB9DE5JKDTKECYPXTGEHV4DQGD,0.1,0.0,p9r,2700,17,120,10,0,7,120,0.10444444444444445,1
MTURK,1c4a09c264cc784a227191d775b213b,39RRBHZ0AU2C9IB0OP7WKATVNMHVZW,0.1,0.0,p9r,2700,2,30,2,30,0,0,0.10111111111111111,1
MTURK,1c4a09c264cc784a227191d775b213b,3WGCNLZJKF9TK5Q6PTYAMU3CA041DI,0.1,0.0,p9r,2700,29,30,5,0,24,30,0.10111111111111111,1
MTURK,1c4a09c264cc784a227191d775b213b,31MCUE39BKNS6SECEND1G8L6LCV3GJ,0.1,0.0,p9r,2700,29,30,5,0,24,30,0.10111111111111111,1
MTURK,1c4a09c264cc784a227191d775b213b,32TZXEA1OLLGK97DWIXHJQ96XN9143,0.1,0.0,p9r,2700,29,30,5,0,24,30,0.10111111111111111,1
MTURK,1c4a09c264cc784a227191d775b213b,3XQ4XW3OD9D6BFRK5NTDMCZH39RS2J,0.1,1.0,p9r,2700,29,60,5,0,24,60,0.10222222222222223,1
MTURK,1c4a09c264cc784a227191d775b213b,3W9XHF7WGKW27V8PJT47WDHXMTHTKN,0.06,0.0,p9r,2700,21,360,9,253,12,107,0.06799999999999999,1
MTURK,1c4a09c264cc784a227191d775b213b,3EQPA8A373VID229SKBOPKYP4FKJZI,0.5,21.0,Jamie Macbeth,3600,22,810,18,607,4,203,0.6125,1
MTURK,1c4a09c264cc784a227191d775b213b,3XD2A6FGFMTW6E3MBGQ34XNJLV89S8,0.5,21.0,Jamie Macbeth,3600,25,870,21,607,4,263,0.6208333333333333,1
MTURK,1c4a09c264cc784a227191d775b213b,3EN4YVUOUBRT872UR2N3SZIEWFMJXL,0.5,21.0,Jamie Macbeth,3600,28,900,21,607,7,293,0.625,1
MTURK,1c4a09c264cc784a227191d775b213b,356ZPKYPUHIZZ84Z6RWE0BVBV54YPH,0.04,0.0,p9r,1500,7,61,6,30,1,31,0.041626666666666666,1
MTURK,1c4a09c264cc784a227191d775b213b,3J94SKDEKIQS8NRPQG0MPKGTMHYD53,0.06,0.0,p9r,1500,7,61,6,30,1,31,0.062439999999999996,1
MTURK,1c4a09c264cc784a227191d775b213b,31S7M7DAGGRDR1Q74TG8BDUCBTMLTI,0.06,0.0,p9r,1500,7,31,6,0,1,31,0.061239999999999996,1
MTURK,1c4a09c264cc784a227191d775b213b,3VW0145YLYD3JGCNSB3J9KMSDWLJMD,0.06,0.0,p9r,1500,7,60,6,0,1,60,0.0624,1
MTURK,1c4a09c264cc784a227191d775b213b,3BJKPTD2QCDOUZLK9DD4XP3BHLBRTE,0.06,0.0,p9r,1500,5,360,5,359,0,1,0.0744,1
MTURK,1c4a09c264cc784a227191d775b213b,3I01FDIL6M909Q828XYORDDH2782DS,0.06,0.0,p9r,1500,7,360,7,299,0,61,0.0744,1
MTURK,1c4a09c264cc784a227191d775b213b,368IUKXGA59XGOUT081MHKBIWVD6PR,0.06,0.0,p9r,1500,5,360,5,299,0,61,0.0744,1
MTURK,1c4a09c264cc784a227191d775b213b,3T5ZXGO9DEPK4AFJ2QDMENUN6VVQZS,0.06,0.0,p9r,1500,6,180,6,120,0,60,0.0672,1
MTURK,1c4a09c264cc784a227191d775b213b,3S829FDFT221A6BZWMJHH37DFG8DXD,0.06,0.0,p9r,1500,11,330,8,218,3,112,0.0732,1
MTURK,1c4a09c264cc784a227191d775b213b,3QTFNPMJC6JZ1D2RMYL5ATZI1K8NZ2,0.06,0.0,p9r,2700,13,360,10,218,3,142,0.06799999999999999,1
MTURK,1c4a09c264cc784a227191d775b213b,3L21G7IH47XWIGLXLPLOZFDDSP0Y1F,0.06,0.0,p9r,1500,8,300,5,189,3,111,0.072,1
MTURK,1c4a09c264cc784a227191d775b213b,3X55NP42EOHYJ57BH63OAHZYM4C3PJ,0.06,0.0,p9r,1500,7,240,6,173,1,67,0.0696,1
MTURK,1c4a09c264cc784a227191d775b213b,3I6NF2WGIGXVK71GS61UV5JQZ9FG5H,0.06,0.0,p9r,1500,7,240,6,173,1,67,0.0696,1
MTURK,1c4a09c264cc784a227191d775b213b,389A2A304OJJ8OZATEZZOJ2KK9DC0J,0.06,0.0,p9r,2700,10,180,10,120,0,60,0.064,1
MTURK,1c4a09c264cc784a227191d775b213b,3X878VYTIEJ4TBJ45FA9B4XAP0B7FP,0.06,0.0,p9r,1500,111,701,50,576,61,125,0.08804,0
MTURK,1c4a09c264cc784a227191d775b213b,3ULIZ0H1VA6YGSBDANGROIFKXKX517,0.06,0.0,p9r,1500,121,708,58,578,63,130,0.08832,0
MTURK,1c4a09c264cc784a227191d775b213b,3EFNPKWBMSPVVO3R0LOYVGYQEW0039,0.06,0.0,p9r,2700,244,750,119,582,125,168,0.07666666666666666,0
MTURK,1c4a09c264cc784a227191d775b213b,3W0KKJIARRAJ9BG1GVTC5HLA8GYK8R,0.06,0.0,p9r,2700,243,690,118,582,125,108,0.07533333333333334,0
MTURK,1c4a09c264cc784a227191d775b213b,3JUDR1D0D6SUYZC7DJ48RCKGLMY2QY,0.06,0.0,p9r,1500,119,529,56,458,63,71,0.08116,0
MTURK,1c4a09c264cc784a227191d775b213b,3DZKABX2ZI6Z1P0QWBNO9CSAE5QCVB,0.06,0.0,p9r,2700,242,570,117,462,125,108,0.07266666666666666,0
MTURK,1c4a09c264cc784a227191d775b213b,3K1H3NEY7L0QOKG97CJDTH7ICQEGDQ,0.06,0.0,p9r,1500,160,421,75,339,85,82,0.07683999999999999,0
MTURK,1c4a09c264cc784a227191d775b213b,3DA79LNS59WWBX0IYNC8FR0VB7Y3TP,0.06,0.0,p9r,2700,287,360,132,224,155,136,0.06799999999999999,0
MTURK,1c4a09c264cc784a227191d775b213b,306996CF6WL058SMBX74R4FC7GK1B5,0.06,0.0,p9r,1500,159,241,74,160,85,81,0.06964,0
MTURK,1c4a09c264cc784a227191d775b213b,31GN6YMHLPTSNVPRJ7IKAJF67HEWSZ,0.06,0.0,p9r,2700,286,300,131,165,155,135,0.06666666666666667,0
MTURK,1c4a09c264cc784a227191d775b213b,3S829FDFT221A6BZWMJHH37DFG9DXE,0.06,0.0,p9r,1500,85,634,35,507,50,127,0.08535999999999999,0
MTURK,1c4a09c264cc784a227191d775b213b,3K3G488TR29MXWVUV266PJNS5WQ5Q3,0.06,0.0,p9r,2700,127,660,55,512,72,148,0.07466666666666666,0
MTURK,1c4a09c264cc784a227191d775b213b,3M4KL7H8KVOUZWBRF6QWGOTKTF816J,0.06,0.0,p9r,1500,84,422,34,296,50,126,0.07688,0
MTURK,1c4a09c264cc784a227191d775b213b,359AP8GAGGLXQZZUEDK83YC7SNKC7K,0.06,0.0,p9r,1500,124,330,52,183,72,147,0.0732,0
MTURK,1c4a09c264cc784a227191d775b213b,3FCO4VKOZ4ECNXJ8A4Q3TMCADZX7E8,0.06,0.0,p9r,2700,125,330,53,183,72,147,0.06733333333333333,0
MTURK,1c4a09c264cc784a227191d775b213b,3B9J25CZ26YTJ7Q549VWIXFND3CCSZ,2.89,0.0,Sara Peck,7200,2,60,2,60,0,0,2.9140833333333336,1
MTURK,1c4a09c264cc784a227191d775b213b,31ODACBENUGN3YT57YJEIUXKJGYSQS,0.06,0.0,p9r,2700,7,631,7,631,0,0,0.07402222222222221,1
MTURK,1c4a09c264cc784a227191d775b213b,391FPZIE4CNQ5IM6DDRKOHN7DQNHU1,0.06,0.0,p9r,1500,4,601,4,601,0,0,0.08404,1
MTURK,1c4a09c264cc784a227191d775b213b,3BPP3MA3TCLB2I8AEYRDCRUB8J2LEV,0.06,0.0,p9r,1500,4,391,4,391,0,0,0.07564,1
MTURK,1c4a09c264cc784a227191d775b213b,3SBNLSTU6U6QF1BEX472EONONG9DZD,0.06,0.0,p9r,2700,5,270,5,241,0,29,0.066,1
MTURK,1c4a09c264cc784a227191d775b213b,3NCN4N1H1GI3JFZBGK52OBSFAHPBNN,0.06,0.0,p9r,2700,5,2430,5,1769,0,661,0.11399999999999999,1
MTURK,1c4a09c264cc784a227191d775b213b,302U8RURJZ2ISTXHL1W2PNMMD95VND,0.06,1.0,p9r,1500,3,1500,3,1499,0,1,0.12,1
MTURK,1c4a09c264cc784a227191d775b213b,3W3RSPVVGSSSRE5W4Y6IG9GEU7WLUC,0.06,0.0,p9r,2700,4,1230,4,570,0,660,0.08733333333333333,1
MTURK,1c4a09c264cc784a227191d775b213b,3XJOUITW8USOIY6KWYO4SZT6LZDQTG,0.06,0.0,p9r,2700,8,4800,7,2160,1,2640,0.16666666666666666,1
MTURK,1c4a09c264cc784a227191d775b213b,3BVS8WK9Q0WB5EOKJ4SAJ3WYOIWIBF,0.06,0.0,p9r,1500,5,1502,5,1500,0,2,0.12007999999999999,1
MTURK,1c4a09c264cc784a227191d775b213b,3CESM1J3EI4N0XRUCUFH9EJEPSK6WQ,0.06,0.0,p9r,2700,8,3991,7,1351,1,2640,0.14868888888888887,1
MTURK,1c4a09c264cc784a227191d775b213b,3TLFH2L6Y9P7QF4ZUNY3WHV35T02TF,0.06,0.0,p9r,2700,6,3359,5,720,1,2639,0.13464444444444443,1
MTURK,1c4a09c264cc784a227191d775b213b,388CL5C1RJONMSZC4ZZJXURO0ZVHL8,0.06,0.0,p9r,2700,7,3240,6,602,1,2638,0.132,1
MTURK,1c4a09c264cc784a227191d775b213b,30UZJB2PPK6HC5QDT7VBNORHAIX538,5.0,3.0,Tim Miller,7200,19,7050,2,12,17,7038,9.895833333333334,1
MTURK,1c4a09c264cc784a227191d775b213b,3MQKOF1EE2OBLP7AI0SCCMYHB95WDC,4.0,0.0,STS Lab,10800,39,6340,2,4369,37,1971,6.348148148148148,1
MTURK,1c4a09c264cc784a227191d775b213b,3CMV9YRYP3JGMJLOSRQBYDXLEYBLJA,8.0,0.0,Maedbh King,4200,77,1740,34,67,43,1673,11.314285714285715,0
MTURK,1c4a09c264cc784a227191d775b213b,3FCO4VKOZ4D8KQXH3C0AMNV6LPKE7Z,0.5,0.0,Richard Bateman,900,2,900,2,900,0,0,1.0,1
MTURK,112a14c770ec5b7f907fd95b5c13c,3QXFBUZ4ZLGG6J9XCC0PNKJRIOPUGY,2.0,1.0,HCI Lab,7200,55,581,7,15,48,566,2.161388888888889,1
MTURK,112a14c770ec5b7f907fd95b5c13c,3SSN80MU8CO8LTBNVW2FWBQHC29KXB,2.0,1.0,Tanase Radu Petru,3600,44,865,28,220,16,645,2.4805555555555556,1
MTURK,112a14c770ec5b7f907fd95b5c13c,3ATYLI1PRS13AD16IXAAERHNM2IOJ0,0.25,3262.0,Aristo,28800,32,177,32,168,0,9,0.2515364583333333,1
MTURK,112a14c770ec5b7f907fd95b5c13c,3KI0JD2ZU0HK1CU0HSZJU1QNA7P76O,0.25,3260.0,Aristo,28800,24,53,24,21,0,32,0.25046006944444443,1
MTURK,112a14c770ec5b7f907fd95b5c13c,3VEI3XUCZQW2T1WK52WY5I846O8RPC,0.25,3257.0,Aristo,28800,39,60,39,53,0,7,0.25052083333333336,1
MTURK,112a14c770ec5b7f907fd95b5c13c,3U74KRR67LKF6VXZTCO1184RUU4NTP,0.25,3256.0,Aristo,28800,52,90,49,76,3,14,0.25078125,1
MTURK,112a14c770ec5b7f907fd95b5c13c,3HFWPF5AK8I7NRRAMTZWIPAZNU03S1,0.25,3255.0,Aristo,28800,41,72,38,33,3,39,0.250625,1
MTURK,112a14c770ec5b7f907fd95b5c13c,3YLPJ8OXX7C014WDGHA2R2JXG9Y4XV,0.25,3255.0,Aristo,28800,39,77,38,38,1,39,0.2506684027777778,1
MTURK,112a14c770ec5b7f907fd95b5c13c,3M0556243RJ5NQFYYSJCK4PQ3LXFNA,0.25,3254.0,Aristo,28800,39,55,39,33,0,22,0.25047743055555555,1
MTURK,112a14c770ec5b7f907fd95b5c13c,3H6W48L9F3O71XD64W64SHGLY3NWPK,0.25,3251.0,Aristo,28800,51,71,46,31,5,40,0.25061631944444446,1
MTURK,112a14c770ec5b7f907fd95b5c13c,378G7J1SJKX346OGVIQTY5HHKWMEWI,0.25,3249.0,Aristo,28800,39,66,39,56,0,10,0.25057291666666665,1
MTURK,112a14c770ec5b7f907fd95b5c13c,3EKZL9T8Y7L6AI9D4SYY7E7RKWWHCS,0.25,3249.0,Aristo,28800,38,73,38,39,0,34,0.25063368055555557,1
MTURK,112a14c770ec5b7f907fd95b5c13c,3Y3N5A7N4F855ZBTRHW0WA7646DMYE,0.25,3241.0,Aristo,28800,43,87,43,49,0,38,0.2507552083333333,1
MTURK,112a14c770ec5b7f907fd95b5c13c,3YLTXLH3DE5P47IH9XK4RE6YJFBHP6,0.25,3239.0,Aristo,28800,39,81,39,41,0,40,0.250703125,1
MTURK,112a14c770ec5b7f907fd95b5c13c,3OND0WXMHVEL7GTR0J4TX27U589EHI,0.25,3234.0,Aristo,28800,39,82,39,76,0,6,0.25071180555555556,1
MTURK,112a14c770ec5b7f907fd95b5c13c,36FQTHX3Z2Q865A8B7D1S00ZJ6E3B0,0.25,3235.0,Aristo,28800,33,82,33,72,0,10,0.25071180555555556,1
MTURK,112a14c770ec5b7f907fd95b5c13c,367O8HRHKF7S5NAEM74FSU251UW4SN,0.25,3230.0,Aristo,28800,39,77,39,40,0,37,0.2506684027777778,1
MTURK,112a14c770ec5b7f907fd95b5c13c,3KL228NDMULATKQQCZXEAX8YA5SKG9,0.25,3230.0,Aristo,28800,39,54,39,30,0,24,0.25046875,1
MTURK,112a14c770ec5b7f907fd95b5c13c,3OJX0UFJ0Y69H68US7V6O3V98JUU9O,0.25,3228.0,Aristo,28800,24,63,24,55,0,8,0.250546875,1
MTURK,112a14c770ec5b7f907fd95b5c13c,3EGKVCRQFVR9M87W0S6RIUWCS79BYE,0.25,3228.0,Aristo,28800,37,60,37,55,0,5,0.25052083333333336,1
MTURK,112a14c770ec5b7f907fd95b5c13c,3LOJFQ4BOWE7H0GZA9W64C51XDCKDZ,0.25,3228.0,Aristo,28800,33,68,33,47,0,21,0.25059027777777776,1
MTURK,112a14c770ec5b7f907fd95b5c13c,3XEIP58NLZML473DNRX4A41JAVQZLF,0.25,3228.0,Aristo,28800,38,66,38,20,0,46,0.25057291666666665,1
MTURK,112a14c770ec5b7f907fd95b5c13c,3P6ENY9P78VXNLVDW2UKIH5MX1GIHV,0.25,3228.0,Aristo,28800,38,47,38,21,0,26,0.2504079861111111,1
MTURK,112a14c770ec5b7f907fd95b5c13c,3SZYX62S5FZOI8UMC9PE2VCNECE758,0.25,3228.0,Aristo,28800,50,97,41,65,9,32,0.2508420138888889,1
MTURK,112a14c770ec5b7f907fd95b5c13c,304QEQWKZOJW870KWP04WM2RNTCO0T,0.25,3225.0,Aristo,28800,42,110,42,64,0,46,0.2509548611111111,1
MTURK,112a14c770ec5b7f907fd95b5c13c,3URJ6VVYUOMD7VILFQN68PS445T4OQ,0.25,3223.0,Aristo,28800,40,95,40,83,0,12,0.25082465277777777,1
MTURK,112a14c770ec5b7f907fd95b5c13c,3PKJ68EHDMVTIWFJEKFKUIKMAG5HJ6,0.25,3223.0,Aristo,28800,40,74,40,66,0,8,0.2506423611111111,1
MTURK,112a14c770ec5b7f907fd95b5c13c,38B7Q9C28F4OFVITWPX38XHT5XD69Z,0.25,3223.0,Aristo,28800,38,65,38,55,0,10,0.2505642361111111,1
MTURK,112a14c770ec5b7f907fd95b5c13c,3BDORL6HKJCJZCNG0XASLI9X75SRCX,0.25,3222.0,Aristo,28800,37,67,37,59,0,8,0.25058159722222223,1
MTURK,112a14c770ec5b7f907fd95b5c13c,3BS6ERDL9260ILVA8525UT0JWIS6DG,0.25,3222.0,Aristo,28800,33,63,33,57,0,6,0.250546875,1
MTURK,112a14c770ec5b7f907fd95b5c13c,3W31J70BARVXC8ALAD1VK6NJCD0KCZ,0.25,3221.0,Aristo,28800,26,68,26,49,0,19,0.25059027777777776,1
MTURK,112a14c770ec5b7f907fd95b5c13c,39O0SQZVJM6DNVSK9G2H5WHJ6U2R75,0.25,3221.0,Aristo,28800,37,65,37,51,0,14,0.2505642361111111,1
MTURK,112a14c770ec5b7f907fd95b5c13c,3H781YYV6SHBCPKM0DLIBLAIG24ETS,0.25,3220.0,Aristo,28800,73,99,54,68,19,31,0.250859375,1
MTURK,112a14c770ec5b7f907fd95b5c13c,36818Z1KV2C3NV5G5TD5XPGT1OT3A5,0.25,3219.0,Aristo,28800,36,52,22,9,14,43,0.2504513888888889,1
MTURK,112a14c770ec5b7f907fd95b5c13c,3MXX6RQ9EU4VSVUMUQ0LXPXUEAP4P7,0.25,3219.0,Aristo,28800,50,90,42,37,8,53,0.25078125,1
MTURK,112a14c770ec5b7f907fd95b5c13c,3S1WOPCJFFSHYMOHOJ7E9FN9I0DEJN,0.25,3227.0,Aristo,28800,43,82,43,70,0,12,0.25071180555555556,1
MTURK,112a14c770ec5b7f907fd95b5c13c,31SIZS5W58ENTDXZ5FBN5NYEBKURQ3,0.25,3227.0,Aristo,28800,41,95,41,90,0,5,0.25082465277777777,1
MTURK,112a14c770ec5b7f907fd95b5c13c,3SD15I2WD1T20TTDFGWTHKE755336F,0.25,3226.0,Aristo,28800,38,50,38,28,0,22,0.2504340277777778,1
MTURK,112a14c770ec5b7f907fd95b5c13c,36AZSFEYZ3ZSIECRVHJ7BVSIAQ6VBO,0.25,3224.0,Aristo,28800,39,62,39,46,0,16,0.2505381944444444,1
MTURK,112a14c770ec5b7f907fd95b5c13c,3UQVX1UPFRGI10BF9R27P9ZOMOH202,0.25,3222.0,Aristo,28800,33,67,31,44,2,23,0.25058159722222223,1
MTURK,112a14c770ec5b7f907fd95b5c13c,3P458N04Q0GQYQHQC3REYNMZWV22XX,0.25,3215.0,Aristo,28800,43,794,41,727,2,67,0.25689236111111113,1
MTURK,112a14c770ec5b7f907fd95b5c13c,33P2GD6NRMROTGL1W5FWVXKZP55KH8,0.25,3215.0,Aristo,28800,29,76,29,27,0,49,0.2506597222222222,1
MTURK,112a14c770ec5b7f907fd95b5c13c,3SR6AEG6W4SJDLAI0KGN45ZANKEHY0,0.25,3214.0,Aristo,28800,31,74,31,28,0,46,0.2506423611111111,1
MTURK,112a14c770ec5b7f907fd95b5c13c,37OPIVELUT2IH3CFKE271JH3KTBHAQ,0.25,3214.0,Aristo,28800,41,76,41,69,0,7,0.2506597222222222,1
MTURK,112a14c770ec5b7f907fd95b5c13c,3DQYSJDTYKAIT6T65NMF0OVOTYSEXB,0.25,3213.0,Aristo,28800,36,73,36,19,0,54,0.25063368055555557,1
MTURK,112a14c770ec5b7f907fd95b5c13c,3PR3LXCWSEY1YA2PXC6T8AUD21C9XW,0.25,3212.0,Aristo,28800,34,69,34,26,0,43,0.25059895833333334,1
MTURK,112a14c770ec5b7f907fd95b5c13c,3ZXV7Q5FJANMWMI792AY4TVE4HJCFP,0.25,3212.0,Aristo,28800,30,50,30,19,0,31,0.2504340277777778,1
MTURK,112a14c770ec5b7f907fd95b5c13c,3EHIMLB7F6Y4YFJ0NGIT5SB8U5A8HC,0.25,3210.0,Aristo,28800,39,60,39,54,0,6,0.25052083333333336,1
MTURK,112a14c770ec5b7f907fd95b5c13c,3TFJJUELSGO2VS6VL7VRKA1PVDEC25,0.25,3209.0,Aristo,28800,38,46,38,18,0,28,0.25039930555555556,1
MTURK,112a14c770ec5b7f907fd95b5c13c,3CMIQF80GMPU7UZFDR8PUS7IFXH6QL,0.25,3207.0,Aristo,28800,34,62,34,48,0,14,0.2505381944444444,1
MTURK,112a14c770ec5b7f907fd95b5c13c,336OE47KI1JK6HA2Q8F3Y953KROWV5,0.25,3206.0,Aristo,28800,32,107,32,56,0,51,0.25092881944444445,1
MTURK,112a14c770ec5b7f907fd95b5c13c,3V0TR1NRV91O5ROK57IO7U8ZFOP4AR,0.25,3206.0,Aristo,28800,36,51,36,24,0,27,0.2504427083333333,1
MTURK,112a14c770ec5b7f907fd95b5c13c,3G9UA71JVUTWP7971BT835VSWD97JU,0.25,3203.0,Aristo,28800,40,95,29,49,11,46,0.25082465277777777,1
MTURK,112a14c770ec5b7f907fd95b5c13c,33NKDW9FFWH3W89S9WGKA0VL8MEXC0,0.25,3202.0,Aristo,28800,39,59,38,42,1,17,0.2505121527777778,1
MTURK,112a14c770ec5b7f907fd95b5c13c,3JU8CV4BRKBZWO44DAFUBN3ZV1PPO2,0.25,3200.0,Aristo,28800,41,93,41,66,0,27,0.25080729166666665,1
MTURK,112a14c770ec5b7f907fd95b5c13c,34OWYT6U3VG48FDUYQ6S507YEO8I95,0.25,3199.0,Aristo,28800,19,52,19,22,0,30,0.2504513888888889,1
MTURK,112a14c770ec5b7f907fd95b5c13c,31KSVEGZ33RSDATLHOATXCG0ZLBWRC,0.25,3195.0,Aristo,28800,24,60,24,56,0,4,0.25052083333333336,1
MTURK,112a14c770ec5b7f907fd95b5c13c,3JTPR5MTZRBCDN16V3EN60H9KWEK5R,0.25,3192.0,Aristo,28800,30,58,30,53,0,5,0.25050347222222225,1
MTURK,112a14c770ec5b7f907fd95b5c13c,3XH7ZM9YX1TH1EGDOD01JS8P1KR9R0,0.25,3189.0,Aristo,28800,55,98,46,74,9,24,0.25085069444444447,1
MTURK,112a14c770ec5b7f907fd95b5c13c,3IWA71V4THFEGR0RZ53HO03BC046XI,0.25,3190.0,Aristo,28800,43,95,40,76,3,19,0.25082465277777777,1
MTURK,112a14c770ec5b7f907fd95b5c13c,39I4RL8QGIG3FEWYBDSGOGV3SJF4H2,0.25,3190.0,Aristo,28800,36,54,36,26,0,28,0.25046875,1
MTURK,112a14c770ec5b7f907fd95b5c13c,3RZS0FBRWJ9YNZ71N563GN9I6N5PC4,0.25,3188.0,Aristo,28800,41,91,41,85,0,6,0.25078993055555554,1
MTURK,112a14c770ec5b7f907fd95b5c13c,3QREJ3J432WQFC4RNQUUNPD66MEKLF,0.25,3188.0,Aristo,28800,37,52,37,25,0,27,0.2504513888888889,1
MTURK,112a14c770ec5b7f907fd95b5c13c,36KM3FWE3QBPN18LF3J2L0GWX4370N,0.25,3187.0,Aristo,28800,38,62,38,57,0,5,0.2505381944444444,1
MTURK,112a14c770ec5b7f907fd95b5c13c,31D0ZWOD09Y7636JM6VMVRIMYC9A0H,0.25,3187.0,Aristo,28800,38,63,38,51,0,12,0.250546875,1
MTURK,112a14c770ec5b7f907fd95b5c13c,39RRBHZ0AT0O0CF71VZAXDZL1TSVZU,0.25,3185.0,Aristo,28800,43,92,43,77,0,15,0.2507986111111111,1
MTURK,112a14c770ec5b7f907fd95b5c13c,3IKMEYR0LVUKEQIJDKCP8TEX0MNK2Q,0.25,3185.0,Aristo,28800,33,83,33,46,0,37,0.2507204861111111,1
MTURK,112a14c770ec5b7f907fd95b5c13c,30ZKOOGW2V57DSR1IPZM9W1W34FA1K,0.25,3185.0,Aristo,28800,39,53,39,36,0,17,0.25046006944444443,1
MTURK,112a14c770ec5b7f907fd95b5c13c,30F94FBDNQJD5M82QMJSAD4XD5RBTP,0.25,3183.0,Aristo,28800,37,44,37,14,0,30,0.25038194444444445,1
MTURK,112a14c770ec5b7f907fd95b5c13c,3PEG1BH7ADQE23IFWD509MH1US0KBS,0.25,3182.0,Aristo,28800,25,60,25,57,0,3,0.25052083333333336,1
MTURK,112a14c770ec5b7f907fd95b5c13c,3UAU495MIHRCOTC0UWEOLTQY3IGOUW,0.25,3181.0,Aristo,28800,32,60,32,52,0,8,0.25052083333333336,1
MTURK,112a14c770ec5b7f907fd95b5c13c,3CIS7GGG64IQC2ZB0IBSGHWKZGBEUJ,0.25,3180.0,Aristo,28800,40,82,40,49,0,33,0.25071180555555556,1
MTURK,112a14c770ec5b7f907fd95b5c13c,3GS542CVJUMSWRIFR6NYGR3T92295M,0.25,3179.0,Aristo,28800,34,81,34,38,0,43,0.250703125,1
MTURK,112a14c770ec5b7f907fd95b5c13c,3OKP4QVBP1W4H7H408KPGJ525TYAGK,0.25,3179.0,Aristo,28800,34,79,34,35,0,44,0.2506857638888889,1
MTURK,112a14c770ec5b7f907fd95b5c13c,3X0EMNLXEOOUM8D1EM186FX7RUMPV4,0.25,3176.0,Aristo,28800,25,47,25,26,0,21,0.2504079861111111,1
MTURK,112a14c770ec5b7f907fd95b5c13c,3RQVKZ7ZRJIWJBBZUQNG4O9BU2N727,0.25,3169.0,Aristo,28800,44,898,44,889,0,9,0.2577951388888889,1
MTURK,112a14c770ec5b7f907fd95b5c13c,375VMB7D4IIGB5QBA6BURWQO59MDIG,0.25,3167.0,Aristo,28800,41,101,41,33,0,68,0.2508767361111111,1
MTURK,112a14c770ec5b7f907fd95b5c13c,3PN6H8C9R3P15N7DYIJHAY25S1IADA,0.25,3166.0,Aristo,28800,37,85,37,47,0,38,0.2507378472222222,1
MTURK,112a14c770ec5b7f907fd95b5c13c,3EPG8DX9LJPDOEYM8VJV2H38E6JP5W,0.25,3166.0,Aristo,28800,42,84,42,77,0,7,0.25072916666666667,1
MTURK,112a14c770ec5b7f907fd95b5c13c,3BC9H1KCYTB1AB57VJ2N589X28QWYE,0.25,3163.0,Aristo,28800,41,70,41,55,0,15,0.2506076388888889,1
MTURK,112a14c770ec5b7f907fd95b5c13c,3RBI0I35XD24JD3JLZRL0BY04FW3YF,0.25,3161.0,Aristo,28800,27,77,27,31,0,46,0.2506684027777778,1
MTURK,112a14c770ec5b7f907fd95b5c13c,3VQTAXTYN2KS5ZNRQR92F9QZWJYBUG,0.25,3158.0,Aristo,28800,34,106,34,99,0,7,0.25092013888888887,1
MTURK,112a14c770ec5b7f907fd95b5c13c,3AC6MFV69JHJIBKNW6I6IC8CTEHZH8,0.25,3158.0,Aristo,28800,25,54,25,34,0,20,0.25046875,1
MTURK,112a14c770ec5b7f907fd95b5c13c,33KGGVH24TGJ95ZUTZR0T4CU4PNX1A,0.25,3157.0,Aristo,28800,48,119,44,107,4,12,0.25103298611111113,1
MTURK,112a14c770ec5b7f907fd95b5c13c,386T3MLZLMUTNFD4P8B8Z0CR8O9083,0.25,3156.0,Aristo,28800,48,66,48,57,0,9,0.25057291666666665,1
MTURK,112a14c770ec5b7f907fd95b5c13c,3AA88CN98O2AFBBQ65JKHXF2F1HYKK,0.25,3154.0,Aristo,28800,52,50,52,42,0,8,0.2504340277777778,1
MTURK,112a14c770ec5b7f907fd95b5c13c,3OKP4QVBP1W4H7H408KPGJ525TYGAQ,0.25,3154.0,Aristo,28800,41,61,41,55,0,6,0.2505295138888889,1
MTURK,112a14c770ec5b7f907fd95b5c13c,33K3E8REWVU1K5JFSK0F8EZ2IVU8X6,0.25,3154.0,Aristo,28800,42,106,42,55,0,51,0.25092013888888887,1
MTURK,112a14c770ec5b7f907fd95b5c13c,38RHULDV9XEFKBQ2R1GKJKF9CPTIWV,0.25,3153.0,Aristo,28800,54,96,54,72,0,24,0.25083333333333335,1
MTURK,112a14c770ec5b7f907fd95b5c13c,3GITHABACXKLMW3MAX450LV1UHSN2Y,0.25,3153.0,Aristo,28800,38,46,38,24,0,22,0.25039930555555556,1
MTURK,112a14c770ec5b7f907fd95b5c13c,37PGLWGSJS5OPBWL2NXHV9LEPIKKI1,0.25,3153.0,Aristo,28800,31,62,31,52,0,10,0.2505381944444444,1
MTURK,112a14c770ec5b7f907fd95b5c13c,3ICOHX7ENBAAWGNV2BX8RA8DJR70E2,0.25,3152.0,Aristo,28800,41,120,41,114,0,6,0.25104166666666666,1
MTURK,112a14c770ec5b7f907fd95b5c13c,39O0SQZVJM6DNVSK9G2H5WHJ6U37RM,0.25,3152.0,Aristo,28800,39,58,39,51,0,7,0.25050347222222225,1
MTURK,112a14c770ec5b7f907fd95b5c13c,3BVS8WK9QZUNW8SRWAKOW62O2OBIBF,0.25,3152.0,Aristo,28800,33,79,33,44,0,35,0.2506857638888889,1
MTURK,112a14c770ec5b7f907fd95b5c13c,3MDKGGG61PM7ZAR7UV2KZXI5Z4G6TZ,0.25,3152.0,Aristo,28800,31,86,31,48,0,38,0.2507465277777778,1
MTURK,112a14c770ec5b7f907fd95b5c13c,3YGE63DIN7W4DG9MNBREDGFDQVBW0D,0.25,3151.0,Aristo,28800,39,74,39,54,0,20,0.2506423611111111,1
MTURK,112a14c770ec5b7f907fd95b5c13c,3NSCTNUR2YM61ASKJC1YCMEDFKK5AX,0.25,3149.0,Aristo,28800,53,92,42,57,11,35,0.2507986111111111,1
MTURK,112a14c770ec5b7f907fd95b5c13c,3PCPFX4U4ZPQQNSQEKBTOYKV8WKFQX,0.25,3149.0,Aristo,28800,25,43,25,13,0,30,0.25037326388888886,1
MTURK,112a14c770ec5b7f907fd95b5c13c,3EFNPKWBMRN7MI7YDRGC8J4GS2H30E,0.25,3147.0,Aristo,28800,33,61,33,56,0,5,0.2505295138888889,1
MTURK,112a14c770ec5b7f907fd95b5c13c,3O2Y2UIUCPT4FKUV1FRWSC8M9QSKFA,0.25,3145.0,Aristo,28800,37,162,37,110,0,52,0.25140625,1
MTURK,112a14c770ec5b7f907fd95b5c13c,32PT7WK7DLE1L28SP347NQOZMRQD3H,0.25,3145.0,Aristo,28800,33,72,33,37,0,35,0.250625,1
MTURK,112a14c770ec5b7f907fd95b5c13c,35NNO802AUVPXHHOZ0PXN12IJDPIN4,0.25,3144.0,Aristo,28800,41,83,41,45,0,38,0.2507204861111111,1
MTURK,112a14c770ec5b7f907fd95b5c13c,3UL5XDRDNBISIMZ5MEHKGV8IPWK58T,0.25,3143.0,Aristo,28800,32,84,32,58,0,26,0.25072916666666667,1
MTURK,112a14c770ec5b7f907fd95b5c13c,3ZLW647WAKUEISACSEKQR7XVP0132Y,0.25,3144.0,Aristo,28800,50,82,43,48,7,34,0.25071180555555556,1
MTURK,112a14c770ec5b7f907fd95b5c13c,3SSN80MU8BNLF6LG19XIYJ8TDVNXKD,0.25,3144.0,Aristo,28800,60,83,47,31,13,52,0.2507204861111111,1
MTURK,112a14c770ec5b7f907fd95b5c13c,3K3G488TR17YOQZ188YK2MTIJ26Q5P,0.25,3139.0,Aristo,28800,46,109,42,79,4,30,0.25094618055555556,1
MTURK,112a14c770ec5b7f907fd95b5c13c,37VHPF5VYB2DH78K1O4SU1ESHD6C88,0.25,3138.0,Aristo,28800,56,145,48,94,8,51,0.25125868055555556,1
MTURK,112a14c770ec5b7f907fd95b5c13c,3HY86PZXPXHA358DYU185FRNOJD1E6,0.25,3138.0,Aristo,28800,53,103,49,82,4,21,0.2508940972222222,1
MTURK,112a14c770ec5b7f907fd95b5c13c,3BO3NEOQMZGIDYNZQWKS1VIIK6QAIC,0.25,3137.0,Aristo,28800,39,79,39,44,0,35,0.2506857638888889,1
MTURK,112a14c770ec5b7f907fd95b5c13c,3N3WJQXELRPVYW01YKOQNTRCPMS2LB,0.25,3137.0,Aristo,28800,39,58,39,39,0,19,0.25050347222222225,1
MTURK,112a14c770ec5b7f907fd95b5c13c,3L2OEKSTW89QKA9PXGMHRS6BK1O8YC,0.25,3137.0,Aristo,28800,35,73,35,22,0,51,0.25063368055555557,1
MTURK,112a14c770ec5b7f907fd95b5c13c,3NSCTNUR2YM61ASKJC1YCMEDFKKA52,0.25,3136.0,Aristo,28800,41,69,41,29,0,40,0.25059895833333334,1
MTURK,112a14c770ec5b7f907fd95b5c13c,39HYCOOPKNK27OG2VL9MJPX5MI6DMW,0.25,3132.0,Aristo,28800,52,72,52,60,0,12,0.250625,1
MTURK,112a14c770ec5b7f907fd95b5c13c,3VP28W7DUMJZ4FTH1GU6FRWZDZ4FZQ,0.25,3130.0,Aristo,28800,35,82,35,48,0,34,0.25071180555555556,1
MTURK,112a14c770ec5b7f907fd95b5c13c,3HXK2V1N4JEFC4M0NTRAA1M4T56G2J,0.25,3130.0,Aristo,28800,43,87,43,48,0,39,0.2507552083333333,1
MTURK,112a14c770ec5b7f907fd95b5c13c,3P4ZBJFX2U2VAKOCQTAZGN2HWX1FW1,0.25,3129.0,Aristo,28800,31,41,31,13,0,28,0.25035590277777775,1
MTURK,112a14c770ec5b7f907fd95b5c13c,3MJ9GGZYO25E2D9X1TZ0EFB1VATA21,0.25,3129.0,Aristo,28800,38,60,38,57,0,3,0.25052083333333336,1
MTURK,112a14c770ec5b7f907fd95b5c13c,375VMB7D4IIGB5QBA6BURWQO59NIDM,0.25,3128.0,Aristo,28800,33,71,33,59,0,12,0.25061631944444446,1
MTURK,112a14c770ec5b7f907fd95b5c13c,38B7Q9C28F4OFVITWPX38XHT5XD962,0.25,3127.0,Aristo,28800,42,80,42,36,0,44,0.25069444444444444,1
MTURK,112a14c770ec5b7f907fd95b5c13c,3NOEP8XAU31MQXIWE12QU0US75UPX7,0.25,3127.0,Aristo,28800,25,103,25,52,0,51,0.2508940972222222,1
MTURK,112a14c770ec5b7f907fd95b5c13c,375VSR8FVV8W75YQSBU0WGAIGNFZR5,0.25,3126.0,Aristo,28800,34,60,34,54,0,6,0.25052083333333336,1
MTURK,112a14c770ec5b7f907fd95b5c13c,3URJ6VVYUOMD7VILFQN68PS445SO49,0.25,3122.0,Aristo,28800,25,49,25,18,0,31,0.2504253472222222,1
MTURK,112a14c770ec5b7f907fd95b5c13c,34O39PNDK570P7VAMXEXAY3FPKUBRC,0.25,3123.0,Aristo,28800,38,59,38,55,0,4,0.2505121527777778,1
MTURK,112a14c770ec5b7f907fd95b5c13c,3O4VWC1GEV5EOO8KZZQIQOJCRBMJ30,0.25,3122.0,Aristo,28800,38,65,38,42,0,23,0.2505642361111111,1
MTURK,112a14c770ec5b7f907fd95b5c13c,3CVDZS288GZZ58UYMR4C7P0QYVNFMA,0.25,3121.0,Aristo,28800,47,70,37,53,10,17,0.2506076388888889,1
MTURK,112a14c770ec5b7f907fd95b5c13c,3BAWBGQGYKY5G291I07R6T6MR0G7VF,0.25,3101.0,Aristo,28800,83,2170,42,72,41,2098,0.26883680555555556,1
MTURK,112a14c770ec5b7f907fd95b5c13c,3A520CCNWMZ6XTLDUDU1GGKQSDJAE3,0.25,3099.0,Aristo,28800,36,49,36,27,0,22,0.2504253472222222,1
MTURK,112a14c770ec5b7f907fd95b5c13c,3RDTX9JRTX07JVWYFZ2VEBHP08X79Z,0.25,3096.0,Aristo,28800,38,67,38,55,0,12,0.25058159722222223,1
MTURK,112a14c770ec5b7f907fd95b5c13c,3TL87MO8CLOFZQCDMF3X7CL1YQXFL8,0.25,3096.0,Aristo,28800,34,48,34,26,0,22,0.2504166666666667,1
MTURK,112a14c770ec5b7f907fd95b5c13c,3QX22DUVONGO15GOM69GPB3CMPBMV5,0.25,3094.0,Aristo,28800,37,64,37,54,0,10,0.25055555555555553,1
MTURK,112a14c770ec5b7f907fd95b5c13c,3XDSWAMB21RJNB8GNILSGSZSBJSQCX,0.25,3093.0,Aristo,28800,40,47,40,20,0,27,0.2504079861111111,1
MTURK,112a14c770ec5b7f907fd95b5c13c,3IKDQS3DQDZ66DKXAAGJ7Q86K9BCIG,0.25,3093.0,Aristo,28800,33,65,33,55,0,10,0.2505642361111111,1
MTURK,112a14c770ec5b7f907fd95b5c13c,3WRKFXQBOA6J9GL262Y84H0PNXTIYU,0.25,3092.0,Aristo,28800,32,80,32,45,0,35,0.25069444444444444,1
MTURK,112a14c770ec5b7f907fd95b5c13c,3PCPFX4U4ZPQQNSQEKBTOYKV8WKQF8,0.25,3091.0,Aristo,28800,43,84,43,41,0,43,0.25072916666666667,1
MTURK,112a14c770ec5b7f907fd95b5c13c,3D1TUISJWHZ2S71XW11J1WUCR9IIUW,0.25,3090.0,Aristo,28800,31,42,31,20,0,22,0.25036458333333333,1
MTURK,112a14c770ec5b7f907fd95b5c13c,3GVPRXWRPGT0UWP1JT88R4GSJYK7II,0.25,3088.0,Aristo,28800,35,65,35,57,0,8,0.2505642361111111,1
MTURK,112a14c770ec5b7f907fd95b5c13c,3IYI9285WRZ21O43SS1JJRN6XO0CJS,0.25,3087.0,Aristo,28800,41,65,41,56,0,9,0.2505642361111111,1
MTURK,112a14c770ec5b7f907fd95b5c13c,308KJXFUJQ58MC3AK8JWF2KRVN6ATT,0.25,3087.0,Aristo,28800,33,78,33,43,0,35,0.25067708333333333,1
MTURK,112a14c770ec5b7f907fd95b5c13c,3WRAAIUSBIYF3TCUPIKT455X8JTXAY,0.25,3086.0,Aristo,28800,24,58,24,26,0,32,0.25050347222222225,1
MTURK,112a14c770ec5b7f907fd95b5c13c,3RHLQY6EDS3M3YRWPH9QXVG50RM4DT,0.25,3086.0,Aristo,28800,33,88,33,83,0,5,0.2507638888888889,1
MTURK,112a14c770ec5b7f907fd95b5c13c,36818Z1KV2C3NV5G5TD5XPGT1OTA3C,0.25,3086.0,Aristo,28800,32,64,32,48,0,16,0.25055555555555553,1
MTURK,112a14c770ec5b7f907fd95b5c13c,3VCK0Q0PO4DEQM08VA0RHX2MXJ80NR,0.25,3086.0,Aristo,28800,39,71,39,27,0,44,0.25061631944444446,1
MTURK,112a14c770ec5b7f907fd95b5c13c,3L60IFZKF2HXRQKTQKCZI547XO1HH1,0.25,3082.0,Aristo,28800,39,76,39,51,0,25,0.2506597222222222,1
MTURK,112a14c770ec5b7f907fd95b5c13c,3WUVMVA7OA248OC9Q08E1QL8GJSAZ9,0.25,3081.0,Aristo,28800,40,57,40,31,0,26,0.25049479166666666,1
MTURK,112a14c770ec5b7f907fd95b5c13c,3E22YV8GG05HE34SCVFHWY3U5RKPNN,0.25,3081.0,Aristo,28800,29,67,29,57,0,10,0.25058159722222223,1
MTURK,112a14c770ec5b7f907fd95b5c13c,3SBX2M1TKCMGS7V1U3FAXUN4J6B4QY,0.25,3080.0,Aristo,28800,45,118,43,69,2,49,0.25102430555555555,1
MTURK,112a14c770ec5b7f907fd95b5c13c,3W9XHF7WGJUEYPCWWZWL9GNN0Z0KTI,0.25,3072.0,Aristo,28800,62,917,51,703,11,214,0.25796006944444444,1
MTURK,112a14c770ec5b7f907fd95b5c13c,3X55NP42ENFAAZBIUCV2NK5O0ASP36,0.25,3072.0,Aristo,28800,43,123,43,107,0,16,0.2510677083333333,1
MTURK,112a14c770ec5b7f907fd95b5c13c,3RKHNXPHGVVTY2RLW4MVEC9PJD7KU9,0.25,3072.0,Aristo,28800,37,57,37,31,0,26,0.25049479166666666,1
MTURK,112a14c770ec5b7f907fd95b5c13c,3B286OTISDGE89758E5SDWXIXLFAJO,0.25,3072.0,Aristo,28800,38,63,38,57,0,6,0.250546875,1
MTURK,112a14c770ec5b7f907fd95b5c13c,3ZXNP4Z39QK2KXX74W5LJK8K02E7LW,0.25,3071.0,Aristo,28800,39,70,39,62,0,8,0.2506076388888889,1
MTURK,112a14c770ec5b7f907fd95b5c13c,3R16PJFTS2QUH4X6HYVD18BVK0J4K6,0.25,3071.0,Aristo,28800,25,54,25,24,0,30,0.25046875,1
MTURK,112a14c770ec5b7f907fd95b5c13c,3UUIU9GZC44BG6RTPCSF7R453955TI,0.25,3068.0,Aristo,28800,39,59,39,55,0,4,0.2505121527777778,1
MTURK,112a14c770ec5b7f907fd95b5c13c,3W0KKJIARQ8V05K8T1LQIKR0MMFK8T,0.25,3067.0,Aristo,28800,37,44,37,23,0,21,0.25038194444444445,1
MTURK,112a14c770ec5b7f907fd95b5c13c,3EQPA8A373VF9HFDK6LRUPOR66LZJD,0.25,3065.0,Aristo,28800,26,90,26,87,0,3,0.25078125,1
MTURK,112a14c770ec5b7f907fd95b5c13c,3VO4XFFP14LDBUDKW1DH067EA81Q74,0.25,3065.0,Aristo,28800,38,65,38,50,0,15,0.2505642361111111,1
MTURK,112a14c770ec5b7f907fd95b5c13c,3JVP4ZJHDORMCLPHYUNZCP65BKE0IB,0.25,3065.0,Aristo,28800,39,63,39,46,0,17,0.250546875,1
MTURK,112a14c770ec5b7f907fd95b5c13c,3XEDXEGFX2NDIGF5YX8BP5LI3O30KM,0.25,3063.0,Aristo,28800,33,60,33,55,0,5,0.25052083333333336,1
MTURK,112a14c770ec5b7f907fd95b5c13c,3IJ95K7NDWBB1QBT9CPU2PP240XNGH,0.25,3061.0,Aristo,28800,40,70,40,38,0,32,0.2506076388888889,1
MTURK,112a14c770ec5b7f907fd95b5c13c,3MQY1YVHS2JJLNEP77ZW9QV7DSEB2X,0.25,3062.0,Aristo,28800,23,100,23,87,0,13,0.2508680555555556,1
MTURK,112a14c770ec5b7f907fd95b5c13c,3GV1I4SEO8OJGXJ2LM0TD68O5RU6LW,0.25,3059.0,Aristo,28800,48,90,45,59,3,31,0.25078125,1
MTURK,112a14c770ec5b7f907fd95b5c13c,3Q7TKIAPOS9I16YHV987JCIGMDHDLV,0.25,3058.0,Aristo,28800,41,122,38,82,3,40,0.2510590277777778,1
MTURK,112a14c770ec5b7f907fd95b5c13c,373L46LKQBML5UBFQWK5CSCUD2EKJK,0.25,2.0,Lauryn Smith,180,53,112,24,33,29,79,0.40555555555555556,1
MTURK,112a14c770ec5b7f907fd95b5c13c,3DQYSJDTYKAIT6T65NMF0OVOTYRXET,0.25,3040.0,Aristo,28800,41,61,35,51,6,10,0.2505295138888889,1
MTURK,112a14c770ec5b7f907fd95b5c13c,3ECKRY5B1PVJE6V72O0RIO9RTRXIZL,0.25,3040.0,Aristo,28800,39,62,39,49,0,13,0.2505381944444444,1
MTURK,112a14c770ec5b7f907fd95b5c13c,3PZDSVZ3J4GVPAI9EBNTT0SZEVON4U,0.25,3040.0,Aristo,28800,33,65,33,50,0,15,0.2505642361111111,1
MTURK,112a14c770ec5b7f907fd95b5c13c,3JUDR1D0D5Q6PTGEQPWM4FQ6ZSFQ2O,0.25,3040.0,Aristo,28800,38,67,38,61,0,6,0.25058159722222223,1
MTURK,112a14c770ec5b7f907fd95b5c13c,3R5OYNIC2B8F9G9C9R1T5X9MU96PTO,0.25,3037.0,Aristo,28800,38,79,38,71,0,8,0.2506857638888889,1
MTURK,112a14c770ec5b7f907fd95b5c13c,37ZQELHEQZXBT07FKFNPFU9Z0M9NMP,0.25,3037.0,Aristo,28800,38,77,38,66,0,11,0.2506684027777778,1
MTURK,112a14c770ec5b7f907fd95b5c13c,3QHITW7OYN8VUWBI34P1AX94BG7QAV,0.25,3034.0,Aristo,28800,39,80,39,45,0,35,0.25069444444444444,1
MTURK,112a14c770ec5b7f907fd95b5c13c,3OREP8RUT1A90HMW6MKLBUP8NBJGBL,0.25,3034.0,Aristo,28800,41,87,41,47,0,40,0.2507552083333333,1
MTURK,112a14c770ec5b7f907fd95b5c13c,3WRAAIUSBIYF3TCUPIKT455X8JUAXC,0.25,3034.0,Aristo,28800,38,47,38,19,0,28,0.2504079861111111,1
MTURK,112a14c770ec5b7f907fd95b5c13c,3SV8KD29L3RAK1LV2RL3V4O4LVLZKC,0.25,3033.0,Aristo,28800,39,63,39,51,0,12,0.250546875,1
MTURK,112a14c770ec5b7f907fd95b5c13c,34ZTTGSNJWNA4JJW9AZTRJW8OBXHQX,0.25,3032.0,Aristo,28800,31,60,31,56,0,4,0.25052083333333336,1
MTURK,112a14c770ec5b7f907fd95b5c13c,3LXX8KJXPV8E41OXWLJXPX3KQX79OR,0.25,3032.0,Aristo,28800,36,65,36,55,0,10,0.2505642361111111,1
MTURK,112a14c770ec5b7f907fd95b5c13c,3DWNFENNE2UZ6KROZDV10TBI5BJJ4M,0.25,3031.0,Aristo,28800,42,94,42,76,0,18,0.25081597222222224,1
MTURK,112a14c770ec5b7f907fd95b5c13c,3H6W48L9F3O71XD64W64SHGLY3OPWE,0.25,3029.0,Aristo,28800,45,106,45,96,0,10,0.25092013888888887,1
MTURK,112a14c770ec5b7f907fd95b5c13c,30EMX9PEVJIDJPZH7ZRVZBR1YGMKST,0.25,3029.0,Aristo,28800,33,77,33,34,0,43,0.2506684027777778,1
MTURK,112a14c770ec5b7f907fd95b5c13c,36MUZ9VAE514V0OPENL36HSWDGGDE8,0.25,3029.0,Aristo,28800,48,109,40,69,8,40,0.25094618055555556,1
MTURK,112a14c770ec5b7f907fd95b5c13c,3HKIF5DF6XWQCO7Z826PKOUIZBGG9B,0.25,3029.0,Aristo,28800,38,54,38,29,0,25,0.25046875,1
MTURK,112a14c770ec5b7f907fd95b5c13c,3MIVREZQVGX169K4FV2Q4BC0GS1QKA,0.25,3029.0,Aristo,28800,50,126,40,83,10,43,0.25109375,1
MTURK,112a14c770ec5b7f907fd95b5c13c,3VO4XFFP14LDBUDKW1DH067EA817QL,0.25,3029.0,Aristo,28800,43,87,42,74,1,13,0.2507552083333333,1
MTURK,112a14c770ec5b7f907fd95b5c13c,3KG2UQJ0MIN2EF57C8U6W3T4AN6QNF,0.25,3029.0,Aristo,28800,40,79,40,33,0,46,0.2506857638888889,1
MTURK,112a14c770ec5b7f907fd95b5c13c,3MNJFORX8A31X19SUSNQQNP4C0X5FA,0.25,3029.0,Aristo,28800,39,62,39,50,0,12,0.2505381944444444,1
MTURK,112a14c770ec5b7f907fd95b5c13c,37YYO3NWHCPFTAYXI0KXWNAB74RCCE,0.25,3028.0,Aristo,28800,39,72,39,31,0,41,0.250625,1
MTURK,112a14c770ec5b7f907fd95b5c13c,389A2A304NHVZI3H6KRD1M8AYFUC0L,0.25,3027.0,Aristo,28800,32,53,32,25,0,28,0.25046006944444443,1
MTURK,112a14c770ec5b7f907fd95b5c13c,3WRBLBQ2GQ78GUJM86NWRDTPW7M0GJ,0.25,3024.0,Aristo,28800,55,125,46,83,9,42,0.2510850694444444,1
MTURK,112a14c770ec5b7f907fd95b5c13c,3Z33IC0JCZL9ULXUXX5BKPXSMQ49VT,0.25,3022.0,Aristo,28800,22,77,21,46,1,31,0.2506684027777778,1
MTURK,112a14c770ec5b7f907fd95b5c13c,3HXCEECSQLS546AC66MU4C3FJAUZY7,0.25,3021.0,Aristo,28800,31,89,31,84,0,5,0.2507725694444444,1
MTURK,112a14c770ec5b7f907fd95b5c13c,3Y3CZJSZ9JSY0RE1LNNK7C3NFO85R5,0.25,3020.0,Aristo,28800,36,110,36,59,0,51,0.2509548611111111,1
MTURK,112a14c770ec5b7f907fd95b5c13c,344M16OZKHEDHCF23HZ62M4QRKINE0,0.25,3020.0,Aristo,28800,55,113,49,70,6,43,0.2509809027777778,1
MTURK,112a14c770ec5b7f907fd95b5c13c,3N3WJQXELRPVYW01YKOQNTRCPMSL2U,0.25,3020.0,Aristo,28800,39,76,38,34,1,42,0.2506597222222222,1
MTURK,112a14c770ec5b7f907fd95b5c13c,3FBEFUUYRJ42KESYOVB34SSDBFV6AE,0.25,3018.0,Aristo,28800,39,76,39,41,0,35,0.2506597222222222,1
MTURK,112a14c770ec5b7f907fd95b5c13c,39AYGO6AFEJ94XMNXZG8QYCDAMU6NY,0.25,3016.0,Aristo,28800,39,71,39,37,0,34,0.25061631944444446,1
MTURK,112a14c770ec5b7f907fd95b5c13c,3NBFJK3IOGHTJBB5ARP7HEP7UA2GOP,0.25,3016.0,Aristo,28800,32,58,32,34,0,24,0.25050347222222225,1
MTURK,112a14c770ec5b7f907fd95b5c13c,3IVEC1GSLOYIELU5CVCZ2V4FTR9J19,0.25,3016.0,Aristo,28800,38,68,38,54,0,14,0.25059027777777776,1
MTURK,112a14c770ec5b7f907fd95b5c13c,3YZ7A3YHR4SA16EE0CNPXM8J1QQS5F,0.25,3014.0,Aristo,28800,43,96,43,79,0,17,0.25083333333333335,1
MTURK,112a14c770ec5b7f907fd95b5c13c,3L4YG5VW9MRZ3UAPISAJ0ZABD4FDDF,0.25,3012.0,Aristo,28800,35,84,35,43,0,41,0.25072916666666667,1
MTURK,112a14c770ec5b7f907fd95b5c13c,3MIVREZQVGX169K4FV2Q4BC0GS1KQ4,0.25,3012.0,Aristo,28800,33,80,33,36,0,44,0.25069444444444444,1
MTURK,112a14c770ec5b7f907fd95b5c13c,3XAOZ9UYRYQZ08YI7LW8ZWG17M1Q17,0.25,3011.0,Aristo,28800,33,93,33,87,0,6,0.25080729166666665,1
MTURK,112a14c770ec5b7f907fd95b5c13c,3E6L1VR4XVLXG596ZBXVIT348V8F60,0.25,3011.0,Aristo,28800,27,75,27,27,0,48,0.2506510416666667,1
MTURK,112a14c770ec5b7f907fd95b5c13c,3J9L0X0VDELM9AXZN7A76RG6TZ69W3,0.25,3008.0,Aristo,28800,53,120,53,112,0,8,0.25104166666666666,1
MTURK,112a14c770ec5b7f907fd95b5c13c,3XUSYT70IS054A9V6GMOLSQSJF6D0M,0.25,3005.0,Aristo,28800,41,87,39,45,2,42,0.2507552083333333,1
MTURK,112a14c770ec5b7f907fd95b5c13c,3VDVA3ILICE8NJ444PRW5ICZ1ZSG12,0.25,2990.0,Aristo,28800,53,953,37,564,16,389,0.25827256944444443,1
MTURK,112a14c770ec5b7f907fd95b5c13c,3U18MJKL1TLYKEVO7QTBCY4N685CNW,0.25,2988.0,Aristo,28800,47,96,47,87,0,9,0.25083333333333335,1
MTURK,112a14c770ec5b7f907fd95b5c13c,3YZ7A3YHR4SA16EE0CNPXM8J1QR5ST,0.25,2987.0,Aristo,28800,31,69,31,57,0,12,0.25059895833333334,1
MTURK,112a14c770ec5b7f907fd95b5c13c,3WRBLBQ2GQ78GUJM86NWRDTPW7MG0Z,0.25,2983.0,Aristo,28800,49,123,43,74,6,49,0.2510677083333333,1
MTURK,112a14c770ec5b7f907fd95b5c13c,3H5TOKO3D8INIPCHFU1CRP6DJ5Z643,0.25,2983.0,Aristo,28800,35,82,33,29,2,53,0.25071180555555556,1
MTURK,112a14c770ec5b7f907fd95b5c13c,3P888QFVX2TKW05JDNUJBST90XBQOU,0.25,2953.0,Aristo,28800,48,1090,41,322,7,768,0.25946180555555554,1
MTURK,112a14c770ec5b7f907fd95b5c13c,3D1UCPY6GF8P47C18VTR1YAYB0T836,0.25,2875.0,Aristo,28800,43,4662,41,2753,2,1909,0.29046875,1
MTURK,112a14c770ec5b7f907fd95b5c13c,3R15W654VCSCQF2M0VERJBPF5S6QLD,0.25,2873.0,Aristo,28800,42,80,42,71,0,9,0.25069444444444444,1
MTURK,112a14c770ec5b7f907fd95b5c13c,373L46LKP65KKMGRK5IH7A0E2X9JKC,0.25,2873.0,Aristo,28800,41,75,41,71,0,4,0.2506510416666667,1
MTURK,112a14c770ec5b7f907fd95b5c13c,3BAKUKE49GBZC9DIK0L84MQ6383R19,0.25,2871.0,Aristo,28800,41,77,41,36,0,41,0.2506684027777778,1
MTURK,112a14c770ec5b7f907fd95b5c13c,3M93N4X8HJMI85TZPERJYWROJRMJST,0.25,2871.0,Aristo,28800,33,52,33,21,0,31,0.2504513888888889,1
MTURK,112a14c770ec5b7f907fd95b5c13c,302U8RURJY0UJN1OY7OG2QSCRFLNV6,0.25,2870.0,Aristo,28800,38,61,38,55,0,6,0.2505295138888889,1
MTURK,112a14c770ec5b7f907fd95b5c13c,3ATYLI1PRS13AD16IXAAERHNM2JJOW,0.25,2870.0,Aristo,28800,36,52,36,24,0,28,0.2504513888888889,1
MTURK,112a14c770ec5b7f907fd95b5c13c,3NQUW096N576YGL0JT35XGZQVS2L9M,0.25,2867.0,Aristo,28800,35,95,32,71,3,24,0.25082465277777777,1
MTURK,112a14c770ec5b7f907fd95b5c13c,3HYV4299HZVSE5SYXFANKPEV2PJ8EX,0.25,2864.0,Aristo,28800,28,60,28,53,0,7,0.25052083333333336,1
MTURK,112a14c770ec5b7f907fd95b5c13c,3GL25Y6842TG5ULJMLAYDW0X20IXMI,0.25,2863.0,Aristo,28800,30,63,30,49,0,14,0.250546875,1
MTURK,112a14c770ec5b7f907fd95b5c13c,356ZPKYPUGGBQ286JXOSDE119BOPYD,0.25,2863.0,Aristo,28800,28,62,28,51,0,11,0.2505381944444444,1
MTURK,112a14c770ec5b7f907fd95b5c13c,3TZDZ3Y0JR5T89HWQJLMD1QCXMX914,0.25,2860.0,Aristo,28800,23,63,23,43,0,20,0.250546875,1
MTURK,112a14c770ec5b7f907fd95b5c13c,3S8A4GJRD22MC2VWZQ2Z0F6QWPWV64,0.25,2856.0,Aristo,28800,36,90,36,84,0,6,0.25078125,1
MTURK,112a14c770ec5b7f907fd95b5c13c,3TY2U1TEB69P92A92KI56V01N89JJD,0.25,2853.0,Aristo,28800,30,51,30,25,0,26,0.2504427083333333,1
MTURK,112a14c770ec5b7f907fd95b5c13c,3W0KKJIARQ8V05K8T1LQIKR0MMF8KH,0.25,2853.0,Aristo,28800,30,66,30,57,0,9,0.25057291666666665,1
MTURK,112a14c770ec5b7f907fd95b5c13c,3GVPRXWRPGT0UWP1JT88R4GSJYKI7T,0.25,2852.0,Aristo,28800,38,79,38,40,0,39,0.2506857638888889,1
MTURK,112a14c770ec5b7f907fd95b5c13c,3IV1AEQ4DQC0PLEQBGLEH5RN7XFJ8T,0.25,2851.0,Aristo,28800,36,85,36,54,0,31,0.2507378472222222,1
MTURK,112a14c770ec5b7f907fd95b5c13c,33IXYHIZB4HHSQQ9HY1MAY1SGPRE20,0.25,2849.0,Aristo,28800,45,79,41,62,4,17,0.2506857638888889,1
MTURK,112a14c770ec5b7f907fd95b5c13c,3B286OTISDGE89758E5SDWXIXLFJAX,0.25,2847.0,Aristo,28800,39,68,39,58,0,10,0.25059027777777776,1
MTURK,112a14c770ec5b7f907fd95b5c13c,30U1YOGZG9V55JT7FI58VYWBE7PDS9,0.25,2847.0,Aristo,28800,44,78,37,23,7,55,0.25067708333333333,1
MTURK,112a14c770ec5b7f907fd95b5c13c,3SU800BH85RF95PG996SAYLYIJZQU7,0.25,2847.0,Aristo,28800,73,169,48,95,25,74,0.25146701388888887,1
MTURK,112a14c770ec5b7f907fd95b5c13c,3RSBJ6YZEBPN5BFAZ7JPZTPVTV2FOP,0.25,2847.0,Aristo,28800,21,87,21,49,0,38,0.2507552083333333,1
MTURK,112a14c770ec5b7f907fd95b5c13c,3OCZWXS7ZN6NXTJOG3QOL0UO9WJ5LF,0.25,2679.0,Aristo,28800,61,5545,52,5437,9,108,0.29813368055555556,1
MTURK,112a14c770ec5b7f907fd95b5c13c,3B9XR6P1WDUJRJCXES5O87HOF30BJK,0.25,2663.0,Aristo,28800,49,80,48,54,1,26,0.25069444444444444,1
MTURK,112a14c770ec5b7f907fd95b5c13c,362E9TQF2GPJNP02CWC2XHTLI13GIU,0.25,2663.0,Aristo,28800,38,69,38,53,0,16,0.25059895833333334,1
MTURK,112a14c770ec5b7f907fd95b5c13c,385MDVINFBEBFMA89J1KVLU9P4IJW8,0.25,2667.0,Aristo,28800,42,99,42,75,0,24,0.250859375,1
MTURK,112a14c770ec5b7f907fd95b5c13c,37VE3DA4YTGN0DH7QS23WU192BWBHF,0.25,2666.0,Aristo,28800,38,66,38,58,0,8,0.25057291666666665,1
MTURK,112a14c770ec5b7f907fd95b5c13c,3RBI0I35XD24JD3JLZRL0BY04FWY3A,0.25,2674.0,Aristo,28800,44,95,41,81,3,14,0.25082465277777777,1
MTURK,112a14c770ec5b7f907fd95b5c13c,3KG2UQJ0MIN2EF57C8U6W3T4AN6NQC,0.25,2677.0,Aristo,28800,47,82,45,72,2,10,0.25071180555555556,1
MTURK,112a14c770ec5b7f907fd95b5c13c,3YO4AH2FPCJZTJD0B2S8LRXR2UVQ04,0.25,2673.0,Aristo,28800,33,81,33,46,0,35,0.250703125,1
MTURK,112a14c770ec5b7f907fd95b5c13c,3HFWPF5AK8I7NRRAMTZWIPAZNU13S2,0.25,2677.0,Aristo,28800,30,72,30,27,0,45,0.250625,1
MTURK,112a14c770ec5b7f907fd95b5c13c,33J5JKFMK5XVABCXUPARNPVY56G3QD,0.25,2675.0,Aristo,28800,43,101,43,87,0,14,0.2508767361111111,1
MTURK,112a14c770ec5b7f907fd95b5c13c,3IZPORCT1E8AGKYWMPOTW96DKXZRH8,0.25,2677.0,Aristo,28800,39,54,39,33,0,21,0.25046875,1
MTURK,112a14c770ec5b7f907fd95b5c13c,3Y3CZJSZ9JSY0RE1LNNK7C3NFO8R5R,0.25,2668.0,Aristo,28800,39,70,39,31,0,39,0.2506076388888889,1
MTURK,112a14c770ec5b7f907fd95b5c13c,3HEM8MA6H8B2H0HKSN7Y0SYZA27QPB,0.25,2677.0,Aristo,28800,33,54,33,31,0,23,0.25046875,1
MTURK,112a14c770ec5b7f907fd95b5c13c,3KQC8JMJGBRIXIDUBZNXEB3XEJK3HH,0.25,2676.0,Aristo,28800,34,68,34,59,0,9,0.25059027777777776,1
MTURK,112a14c770ec5b7f907fd95b5c13c,30U1YOGZG9V55JT7FI58VYWBE7PSDO,0.25,2659.0,Aristo,28800,35,74,35,40,0,34,0.2506423611111111,1
MTURK,112a14c770ec5b7f907fd95b5c13c,3DFYDSXB2VZYNIL3EJMJDX9C4O7JU9,0.25,2659.0,Aristo,28800,32,80,32,54,0,26,0.25069444444444444,1
MTURK,112a14c770ec5b7f907fd95b5c13c,3M7OI89LVXNQDTPW897UANI1BIH6CH,0.25,2663.0,Aristo,28800,41,407,41,355,0,52,0.25353298611111114,1
MTURK,112a14c770ec5b7f907fd95b5c13c,3O71U79SRAO89DZKSB4BEOJ5NLHSM6,0.25,2655.0,Aristo,28800,26,50,26,21,0,29,0.2504340277777778,1
MTURK,112a14c770ec5b7f907fd95b5c13c,3T5ZXGO9DDNWV4JQFW50RQ0DK1EQZW,0.25,2653.0,Aristo,28800,38,62,38,54,0,8,0.2505381944444444,1
MTURK,112a14c770ec5b7f907fd95b5c13c,3BKZLF990YYWQE9LJA3HDJRBE7AYQD,0.25,2648.0,Aristo,28800,53,104,48,54,5,50,0.25090277777777775,1
MTURK,112a14c770ec5b7f907fd95b5c13c,3LN50BUKPUARQ3170IZ2J6Z50WKLPH,0.25,2655.0,Aristo,28800,32,61,32,49,0,12,0.2505295138888889,1
MTURK,112a14c770ec5b7f907fd95b5c13c,3MDWE879UG1UL7ZOSGEBJD3LJYO9BN,0.25,2660.0,Aristo,28800,39,67,39,52,0,15,0.25058159722222223,1
MTURK,112a14c770ec5b7f907fd95b5c13c,3PA41K45VM3SBIC5WOYS01H45CF7PU,0.25,2655.0,Aristo,28800,40,72,40,18,0,54,0.250625,1
MTURK,112a14c770ec5b7f907fd95b5c13c,3KVQ0UJWPWK38NVNKHXQUBB473N5W8,0.25,2655.0,Aristo,28800,39,65,39,53,0,12,0.2505642361111111,1
MTURK,112a14c770ec5b7f907fd95b5c13c,39N6W9XWRCM5DPF7GEY5J5N98K1YGI,0.25,2651.0,Aristo,28800,42,76,42,24,0,52,0.2506597222222222,1
MTURK,112a14c770ec5b7f907fd95b5c13c,3YD0MU1NC10LOE6375GVA6S96QF7AE,0.25,2647.0,Aristo,28800,54,99,50,75,4,24,0.250859375,1
MTURK,112a14c770ec5b7f907fd95b5c13c,3R15W654VCSCQF2M0VERJBPF5S6LQ8,0.25,2644.0,Aristo,28800,33,54,33,31,0,23,0.25046875,1
MTURK,112a14c770ec5b7f907fd95b5c13c,3ZQA3IO31AQWFWL2S844ARL1SLJO1X,0.25,2644.0,Aristo,28800,40,71,40,56,0,15,0.25061631944444446,1
MTURK,112a14c770ec5b7f907fd95b5c13c,38F60IALAFGCLZ5SS6M3QW8EM1UT0L,0.25,2642.0,Aristo,28800,32,70,32,63,0,7,0.2506076388888889,1
MTURK,112a14c770ec5b7f907fd95b5c13c,3DA79LNS58U82R4PBT4MSU6LPDET3G,0.25,2641.0,Aristo,28800,41,57,41,45,0,12,0.25049479166666666,1
MTURK,112a14c770ec5b7f907fd95b5c13c,39RRBHZ0AT0O0CF71VZAXDZL1TTVZV,0.25,2640.0,Aristo,28800,23,80,23,35,0,45,0.25069444444444444,1
MTURK,112a14c770ec5b7f907fd95b5c13c,3ZVPAMTJWM2WGO3L2J6BB9UC5XMRG9,0.25,2636.0,Aristo,28800,54,119,49,90,5,29,0.25103298611111113,1
MTURK,112a14c770ec5b7f907fd95b5c13c,3LVTFB9DE4HW4NOLP4HB6JK79BKQG7,0.25,2620.0,Aristo,28800,32,85,31,40,1,45,0.2507378472222222,1
MTURK,112a14c770ec5b7f907fd95b5c13c,3HJ1EVZS2NIVMCRX74ZRSF531SI3RE,0.25,2616.0,Aristo,28800,33,52,33,29,0,23,0.2504513888888889,1
MTURK,112a14c770ec5b7f907fd95b5c13c,3J6BHNX0U8RG3C7CZ3A90HHVBHEKNH,0.25,2601.0,Aristo,28800,38,120,35,99,3,21,0.25104166666666666,1
MTURK,112a14c770ec5b7f907fd95b5c13c,3TTPFEFXCSJHU10CU1LVLEFHOAM6HQ,0.25,2601.0,Aristo,28800,38,55,38,38,0,17,0.25047743055555555,1
MTURK,112a14c770ec5b7f907fd95b5c13c,3E6L1VR4XVLXG596ZBXVIT348V96FS,0.25,2610.0,Aristo,28800,41,96,41,81,0,15,0.25083333333333335,1
MTURK,112a14c770ec5b7f907fd95b5c13c,3I4E7AFQ2JYJN56EEEW981NALA0JTI,0.25,2619.0,Aristo,28800,32,57,32,39,0,18,0.25049479166666666,1
MTURK,112a14c770ec5b7f907fd95b5c13c,3L55D8AUF9WSWDZ2ES2MTE2UAS9YC8,0.25,2615.0,Aristo,28800,42,98,42,57,0,41,0.25085069444444447,1
MTURK,112a14c770ec5b7f907fd95b5c13c,3HA5ODM5K9RRZ0TT63521K2IEETVSQ,0.25,2614.0,Aristo,28800,38,98,38,71,0,27,0.25085069444444447,1
MTURK,112a14c770ec5b7f907fd95b5c13c,3V8JSVE8YXP7TBJGAJ8HJ22XV4MYE1,0.25,2612.0,Aristo,28800,21,94,21,87,0,7,0.25081597222222224,1
MTURK,112a14c770ec5b7f907fd95b5c13c,3WRKFXQBOA6J9GL262Y84H0PNXTYIA,0.25,2610.0,Aristo,28800,39,90,37,81,2,9,0.25078125,1
MTURK,112a14c770ec5b7f907fd95b5c13c,3909MD9T2YG1TK2L5TGTUHVHPTWFEL,0.25,2596.0,Aristo,28800,48,625,41,577,7,48,0.2554253472222222,1
MTURK,112a14c770ec5b7f907fd95b5c13c,33Q5P9PUSOLS1397AE457LBWGMDCZD,0.25,2594.0,Aristo,28800,40,66,40,60,0,6,0.25057291666666665,1
MTURK,112a14c770ec5b7f907fd95b5c13c,3GMLHYZ0LDWOI7G20JNMNKO0HSGYUI,0.25,2591.0,Aristo,28800,51,90,47,65,4,25,0.25078125,1
MTURK,112a14c770ec5b7f907fd95b5c13c,3AXFSPQOYPX940ODJURKRX89U1SJFA,0.25,2592.0,Aristo,28800,34,92,34,56,0,36,0.2507986111111111,1
MTURK,112a14c770ec5b7f907fd95b5c13c,3ZFRE2BDQ8DG41K21A0SLYW6H41XZ0,0.25,2592.0,Aristo,28800,36,79,36,42,0,37,0.2506857638888889,1
MTURK,112a14c770ec5b7f907fd95b5c13c,3Q2T3FD0OM74PWE52W3A6GBTV5J3MQ,0.25,2590.0,Aristo,28800,30,55,30,30,0,25,0.25047743055555555,1
MTURK,112a14c770ec5b7f907fd95b5c13c,3XH7ZM9YX1TH1EGDOD01JS8P1KRR9I,0.25,2589.0,Aristo,28800,30,98,30,83,0,15,0.25085069444444447,1
MTURK,112a14c770ec5b7f907fd95b5c13c,3AA88CN98O2AFBBQ65JKHXF2F1IYKL,0.25,2589.0,Aristo,28800,41,71,41,64,0,7,0.25061631944444446,1
MTURK,112a14c770ec5b7f907fd95b5c13c,37NXA7GVSS54VNY3MU81PYONMKLLV2,0.25,2587.0,Aristo,28800,38,57,38,27,0,30,0.25049479166666666,1
MTURK,112a14c770ec5b7f907fd95b5c13c,3ZUE82NE090KKJSUSQUT27ZVEQY8FF,0.25,2585.0,Aristo,28800,36,62,36,56,0,6,0.2505381944444444,1
MTURK,112a14c770ec5b7f907fd95b5c13c,3VEI3XUCZQW2T1WK52WY5I846O9RPD,0.25,2582.0,Aristo,28800,38,101,38,45,0,56,0.2508767361111111,1
MTURK,112a14c770ec5b7f907fd95b5c13c,3CO05SML7U4Z5KS0OHH8QH7WYGY0RG,0.25,2574.0,Aristo,28800,75,142,57,79,18,63,0.2512326388888889,1
MTURK,112a14c770ec5b7f907fd95b5c13c,3HEADTGN2ORFYLTGRE5XBAXMSCARVY,0.25,2573.0,Aristo,28800,40,91,40,71,0,20,0.25078993055555554,1
MTURK,112a14c770ec5b7f907fd95b5c13c,3O4VWC1GEV5EOO8KZZQIQOJCRBN3JL,0.25,2570.0,Aristo,28800,51,126,48,106,3,20,0.25109375,1
MTURK,112a14c770ec5b7f907fd95b5c13c,382GHPVPHRQOL6PZWS3EKMUT9EX34U,0.25,2569.0,Aristo,28800,45,58,45,26,0,32,0.25050347222222225,1
MTURK,112a14c770ec5b7f907fd95b5c13c,38O9DZ0A61MDFBXUBGIOYA9FZR3627,0.25,2574.0,Aristo,28800,37,62,37,40,0,22,0.2505381944444444,1
MTURK,112a14c770ec5b7f907fd95b5c13c,3FCO4VKOZ3COERNFNAIH6PI0R5DE7G,0.25,2568.0,Aristo,28800,53,119,47,100,6,19,0.25103298611111113,1
MTURK,112a14c770ec5b7f907fd95b5c13c,33CLA8O0MHAQ2O7QRZ0TTOU04IMRFA,0.25,2516.0,Aristo,28800,53,1661,53,1601,0,60,0.2644184027777778,1
MTURK,112a14c770ec5b7f907fd95b5c13c,33J5JKFMK5XVABCXUPARNPVY56FQ3Z,0.25,2514.0,Aristo,28800,30,71,30,64,0,7,0.25061631944444446,1
MTURK,112a14c770ec5b7f907fd95b5c13c,3566S7OX5CIPUQT3BMN2Z5Z62WA17L,0.25,2457.0,Aristo,28800,24,1907,24,1858,0,49,0.26655381944444445,1
MTURK,112a14c770ec5b7f907fd95b5c13c,301KG0KX9BKTC0HB7Z9SV1Y585JH2J,0.25,2456.0,Aristo,28800,17,58,17,55,0,3,0.25050347222222225,1
MTURK,112a14c770ec5b7f907fd95b5c13c,30EMX9PEVJIDJPZH7ZRVZBR1YGMSK1,0.25,2454.0,Aristo,28800,40,96,40,79,0,17,0.25083333333333335,1
MTURK,112a14c770ec5b7f907fd95b5c13c,3SBX2M1TKCMGS7V1U3FAXUN4J6BQ4K,0.25,2452.0,Aristo,28800,33,69,33,62,0,7,0.25059895833333334,1
MTURK,112a14c770ec5b7f907fd95b5c13c,3K2CEDRACA09ODCZHB91OTFRP4VTMW,0.25,2451.0,Aristo,28800,25,47,25,16,0,31,0.2504079861111111,1
MTURK,112a14c770ec5b7f907fd95b5c13c,3X52SWXE0W4O7842ZRKY8HHEZK9WC7,0.25,2449.0,Aristo,28800,43,89,43,82,0,7,0.2507725694444444,1
MTURK,112a14c770ec5b7f907fd95b5c13c,31J7RYECZKPO9BI5FGOCIAH7XGF1LU,0.25,2449.0,Aristo,28800,32,52,32,21,0,31,0.2504513888888889,1
MTURK,112a14c770ec5b7f907fd95b5c13c,302OLP89DY6R0V1ZYMO6QSKN716ACA,0.25,2446.0,Aristo,28800,20,62,20,46,0,16,0.2505381944444444,1
MTURK,112a14c770ec5b7f907fd95b5c13c,3JMNNNO3B03B9QC02YVSW48SNTWW2Y,0.25,2442.0,Aristo,28800,58,150,44,54,14,96,0.2513020833333333,1
MTURK,112a14c770ec5b7f907fd95b5c13c,3EQVJH0T4ZKNWZBOQETOWO7V8IWTHN,0.25,2437.0,Aristo,28800,44,131,44,74,0,57,0.25113715277777776,1
MTURK,112a14c770ec5b7f907fd95b5c13c,3XBYQ44Z6O35TP6DLDFOXRHIN69TWN,0.25,2435.0,Aristo,28800,32,78,32,32,0,46,0.25067708333333333,1
MTURK,112a14c770ec5b7f907fd95b5c13c,338431Z1FKEK81KJQ2JJGI3EWJDORT,0.25,2434.0,Aristo,28800,42,91,42,79,0,12,0.25078993055555554,1
MTURK,112a14c770ec5b7f907fd95b5c13c,3O0M2G5VC51A08EFD14OBZXF96849D,0.25,2433.0,Aristo,28800,46,135,33,30,13,105,0.251171875,1
MTURK,112a14c770ec5b7f907fd95b5c13c,3I7SHAD35LVMQFFS4860JXN9074M7D,0.25,2431.0,Aristo,28800,32,89,32,84,0,5,0.2507725694444444,1
MTURK,112a14c770ec5b7f907fd95b5c13c,3YOAVL4CAZGP6ZWSHZYNONZ8O9WZ4N,0.25,2430.0,Aristo,28800,32,76,32,30,0,46,0.2506597222222222,1
MTURK,112a14c770ec5b7f907fd95b5c13c,33N1S8XHHLK8E0Z9UHFLQPS5CPMZ1A,0.25,2429.0,Aristo,28800,77,166,48,105,29,61,0.2514409722222222,1
MTURK,112a14c770ec5b7f907fd95b5c13c,3RZS0FBRWJ9YNZ71N563GN9I6N6PC5,0.25,2428.0,Aristo,28800,45,138,43,105,2,33,0.2511979166666667,1
MTURK,112a14c770ec5b7f907fd95b5c13c,3FTID4TN8KXLZHT8R5VLWXSH41NYLO,0.25,2339.0,Aristo,28800,61,3236,48,661,13,2575,0.2780902777777778,1
MTURK,112a14c770ec5b7f907fd95b5c13c,3D5G8J4N593SE068V3ASBPY4GX7VTF,0.25,2337.0,Aristo,28800,55,158,47,122,8,36,0.25137152777777777,1
MTURK,112a14c770ec5b7f907fd95b5c13c,3TCFMTM8HDNI8PWX5A673EIYRGO125,0.25,2337.0,Aristo,28800,40,87,40,46,0,41,0.2507552083333333,1
MTURK,112a14c770ec5b7f907fd95b5c13c,3L21G7IH47GPFZ7IV3FTXS9MMKR1YX,1.0,1.0,Stanford Open Virtual Assistant Lab,1200,23,212,23,204,0,8,1.1766666666666667,1
MTURK,112a14c770ec5b7f907fd95b5c13c,3P888QFVX3UUZYVA5YZRC5GRDAGQO9,1.0,1.0,SNAP,3600,49,1359,30,195,19,1164,1.3775,1
MTURK,112a14c770ec5b7f907fd95b5c13c,3R15W654VD3GN9I6FE7YSMLG5KULQN,1.0,23.0,CU Learning Lab,3000,74,1274,15,30,59,1244,1.4246666666666665,1
MTURK,112a14c770ec5b7f907fd95b5c13c,30Z7M1Q8UYK45VA81ZS5OEN1N4M8AN,1.0,14.0,Haemin Joo,3600,97,235,76,188,21,47,1.0652777777777778,1
MTURK,112a14c770ec5b7f907fd95b5c13c,3UOMW19E6C5UUPPI3QXPIH41FP7C5C,0.17,1350.0,Aristo,3600,39,220,39,211,0,9,0.1803888888888889,1
MTURK,112a14c770ec5b7f907fd95b5c13c,3S4TINXCCZMXSU3UU5XTG3YAEZCBO9,0.17,1350.0,Aristo,3600,40,162,39,120,1,42,0.17765,1
MTURK,112a14c770ec5b7f907fd95b5c13c,3PCPFX4U4ZPQQNSQEKBTOYKV8WLFQY,0.25,1842.0,Aristo,28800,44,62,44,55,0,7,0.2505381944444444,1
MTURK,112a14c770ec5b7f907fd95b5c13c,3M67TQBQQGNP2XUWM2EFO2JF1G4A9U,0.25,1841.0,Aristo,28800,27,68,26,49,1,19,0.25059027777777776,1
MTURK,112a14c770ec5b7f907fd95b5c13c,335HHSX8CEGV8IIIN2MOJ6WKMMSHD4,0.33,159.0,Coli,1800,21,120,21,114,0,6,0.35200000000000004,1
MTURK,112a14c770ec5b7f907fd95b5c13c,3H781YYV6SHBCPKM0DLIBLAIG25ETT,0.25,1661.0,Aristo,28800,46,137,43,99,3,38,0.2511892361111111,1
MTURK,112a14c770ec5b7f907fd95b5c13c,3BVS8WK9QZUNW8SRWAKOW62O2OCIBG,0.25,1659.0,Aristo,28800,33,78,33,40,0,38,0.25067708333333333,1
MTURK,112a14c770ec5b7f907fd95b5c13c,3VDI8GSXAESQYJOP3A0BKSZ7F5Z8GF,0.25,1658.0,Aristo,28800,38,54,38,43,0,11,0.25046875,1
MTURK,112a14c770ec5b7f907fd95b5c13c,3L60IFZKF2HXRQKTQKCZI547XO2HH2,0.25,1656.0,Aristo,28800,39,71,39,61,0,10,0.25061631944444446,1
MTURK,112a14c770ec5b7f907fd95b5c13c,3XAOZ9UYRYQZ08YI7LW8ZWG17M2Q18,0.25,1653.0,Aristo,28800,38,74,38,23,0,51,0.2506423611111111,1
MTURK,112a14c770ec5b7f907fd95b5c13c,36818Z1KV2C3NV5G5TD5XPGT1OU3A6,0.25,1650.0,Aristo,28800,47,97,45,81,2,16,0.2508420138888889,1
MTURK,112a14c770ec5b7f907fd95b5c13c,3N2YPY1GI5XQPHOB58LXC3Y3DNLVEQ,0.25,1651.0,Aristo,28800,32,62,32,48,0,14,0.2505381944444444,1
MTURK,112a14c770ec5b7f907fd95b5c13c,36MUZ9VAE514V0OPENL36HSWDGHDE9,0.25,1651.0,Aristo,28800,51,101,48,51,3,50,0.2508767361111111,1
MTURK,112a14c770ec5b7f907fd95b5c13c,3QE4DGPGBQAPFI1NR7AY3GJ2DJ3G4G,0.25,1649.0,Aristo,28800,35,356,31,74,4,282,0.25309027777777776,1
MTURK,112a14c770ec5b7f907fd95b5c13c,374UMBUHN4OWFR084MFNLXAFVQSCTY,0.25,1619.0,Aristo,28800,44,467,32,331,12,136,0.25405381944444444,1
MTURK,112a14c770ec5b7f907fd95b5c13c,3PUV2Q8SV336OXC54WJD59MBAJ4DB9,0.25,1619.0,Aristo,28800,43,104,43,91,0,13,0.25090277777777775,1
MTURK,112a14c770ec5b7f907fd95b5c13c,3TTPFEFXCSJHU10CU1LVLEFHOAMH61,0.25,1618.0,Aristo,28800,31,58,31,35,0,23,0.25050347222222225,1
MTURK,112a14c770ec5b7f907fd95b5c13c,3CMIQF80GMPU7UZFDR8PUS7IFXIQ66,0.25,1616.0,Aristo,28800,49,189,45,81,4,108,0.251640625,1
MTURK,112a14c770ec5b7f907fd95b5c13c,31J7RYECZKPO9BI5FGOCIAH7XGFL1E,0.25,1611.0,Aristo,28800,37,87,36,32,1,55,0.2507552083333333,1
MTURK,112a14c770ec5b7f907fd95b5c13c,3RBI0I35XD24JD3JLZRL0BY04FX3YG,0.25,1609.0,Aristo,28800,34,83,34,72,0,11,0.2507204861111111,1
MTURK,112a14c770ec5b7f907fd95b5c13c,37VHPF5VYB2DH78K1O4SU1ESHD78C5,0.25,1605.0,Aristo,28800,22,63,22,58,0,5,0.250546875,1
MTURK,112a14c770ec5b7f907fd95b5c13c,3FVBZG9CLIDMGQEXSC5ECD5QB700HJ,0.25,1601.0,Aristo,28800,39,114,39,108,0,6,0.2509895833333333,1
MTURK,112a14c770ec5b7f907fd95b5c13c,3EPG8DX9LJPDOEYM8VJV2H38E6L5PE,0.25,1597.0,Aristo,28800,37,81,37,40,0,41,0.250703125,1
MTURK,112a14c770ec5b7f907fd95b5c13c,3IVKZBIBJZ8MHZY91EOYMJB96ZJSHY,0.25,1594.0,Aristo,28800,35,111,35,62,0,49,0.2509635416666667,1
MTURK,112a14c770ec5b7f907fd95b5c13c,3OID399FXF6W1EOL9Y59OZDWPHWDFR,0.25,1591.0,Aristo,28800,821,13269,569,1357,252,11912,0.36518229166666666,1
MTURK,112a14c770ec5b7f907fd95b5c13c,356ZPKYPUGGBQ286JXOSDE119BPPYE,0.25,1578.0,Aristo,28800,45,115,41,58,4,57,0.2509982638888889,1
MTURK,112a14c770ec5b7f907fd95b5c13c,3VADEH0UHBWEUGWXKRW3VSD0SQTSP3,0.25,1578.0,Aristo,28800,28,102,28,59,0,43,0.2508854166666667,1
MTURK,112a14c770ec5b7f907fd95b5c13c,3AJA9FLWSBXD9P471C6KFWT9HM4IFY,0.25,1574.0,Aristo,28800,34,88,28,70,6,18,0.2507638888888889,1
MTURK,112a14c770ec5b7f907fd95b5c13c,3HXCEECSQLS546AC66MU4C3FJAVZY8,0.25,1572.0,Aristo,28800,33,65,33,49,0,16,0.2505642361111111,1
MTURK,112a14c770ec5b7f907fd95b5c13c,3N3WJQXELRPVYW01YKOQNTRCPMTL2V,0.25,1570.0,Aristo,28800,31,92,31,81,0,11,0.2507986111111111,1
MTURK,112a14c770ec5b7f907fd95b5c13c,3CZH926SIBDRV45WLCKA3DYQ03OE4X,0.25,1569.0,Aristo,28800,38,83,38,57,0,26,0.2507204861111111,1
MTURK,112a14c770ec5b7f907fd95b5c13c,301KG0KX9BKTC0HB7Z9SV1Y585KH2K,0.25,1568.0,Aristo,28800,39,88,39,55,0,33,0.2507638888888889,1
MTURK,112a14c770ec5b7f907fd95b5c13c,302U8RURJY0UJN1OY7OG2QSCRFMNV7,0.25,1559.0,Aristo,28800,40,85,40,44,0,41,0.2507378472222222,1
MTURK,112a14c770ec5b7f907fd95b5c13c,3J6BHNX0U8RG3C7CZ3A90HHVBHFKNI,0.25,1558.0,Aristo,28800,52,107,49,82,3,25,0.25092881944444445,1
MTURK,112a14c770ec5b7f907fd95b5c13c,3MYASTQBG6ATS3EUNEG30YHAWJ5DQL,0.25,1557.0,Aristo,28800,40,75,40,23,0,52,0.2506510416666667,1
MTURK,112a14c770ec5b7f907fd95b5c13c,3OPLMF3EU4MRNIPUK3MAFHUA0HKNLO,0.25,1555.0,Aristo,28800,43,98,43,88,0,10,0.25085069444444447,1
MTURK,112a14c770ec5b7f907fd95b5c13c,3SMIWMMK604KT2L2LI5Y2N3K6KGUWF,0.25,1556.0,Aristo,28800,25,82,25,78,0,4,0.25071180555555556,1
MTURK,112a14c770ec5b7f907fd95b5c13c,3WUVMVA7OA248OC9Q08E1QL8GJTAZA,0.25,1551.0,Aristo,28800,35,65,35,57,0,8,0.2505642361111111,1
MTURK,112a14c770ec5b7f907fd95b5c13c,3KG2UQJ0MIN2EF57C8U6W3T4AN7NQD,0.25,1539.0,Aristo,28800,32,529,32,481,0,48,0.2545920138888889,1
MTURK,112a14c770ec5b7f907fd95b5c13c,3SBX2M1TKCMGS7V1U3FAXUN4J6CQ4L,0.25,1536.0,Aristo,28800,42,94,42,72,0,22,0.25081597222222224,1
MTURK,112a14c770ec5b7f907fd95b5c13c,37SDSEDIN81TU4YMLRF8D5V1DGG81F,0.25,1532.0,Aristo,28800,25,64,25,42,0,22,0.25055555555555553,1
MTURK,112a14c770ec5b7f907fd95b5c13c,3OLZC0DJ8IE25MQX1RBOXIWV5GSVIZ,0.25,1529.0,Aristo,28800,41,120,37,107,4,13,0.25104166666666666,1
MTURK,112a14c770ec5b7f907fd95b5c13c,3JVP4ZJHDORMCLPHYUNZCP65BKFI0U,0.25,1526.0,Aristo,28800,32,109,28,92,4,17,0.25094618055555556,1
MTURK,112a14c770ec5b7f907fd95b5c13c,3PGQRAZX01J83UOYBESM8J6CWVWSYX,0.25,1525.0,Aristo,28800,44,140,38,129,6,11,0.2512152777777778,1
MTURK,112a14c770ec5b7f907fd95b5c13c,33BFF6QPI0A0U88J6Y9XFEDKT7XW3A,0.25,1424.0,Aristo,28800,24,3609,15,223,9,3386,0.281328125,1
MTURK,112a14c770ec5b7f907fd95b5c13c,31ANT7FQN71LBX0YPIBQT81HSFBH5L,0.25,1420.0,Aristo,28800,8,8,8,7,0,1,0.25006944444444446,1
MTURK,112a14c770ec5b7f907fd95b5c13c,3BC9H1KCYTB1AB57VJ2N589X28SYWI,0.25,1304.0,Aristo,28800,2,71,2,71,0,0,0.25061631944444446,1
MTURK,112a14c770ec5b7f907fd95b5c13c,33QQ60S6ARHRLCKHSBCDVSUG5F30UL,0.25,1183.0,Aristo,28800,11,22,11,20,0,2,0.2501909722222222,1
MTURK,112a14c770ec5b7f907fd95b5c13c,3G4VVJO6PYFG6XJPFIN146MQBWGPKJ,0.25,1185.0,Aristo,28800,11,67,11,12,0,55,0.25058159722222223,1
MTURK,112a14c770ec5b7f907fd95b5c13c,38RHULDV9XEFKBQ2R1GKJKF9CPUWIA,0.25,1145.0,Aristo,28800,11,77,9,75,2,2,0.2506684027777778,1
MTURK,112a14c770ec5b7f907fd95b5c13c,3DFYDSXB2VZYNIL3EJMJDX9C4O8JUA,0.25,1023.0,Aristo,28800,8,71,8,89,0,-18,0.25061631944444446,1
MTURK,112a14c770ec5b7f907fd95b5c13c,3PEG1BH7ADQE23IFWD509MH1US1BKK,0.25,1017.0,Aristo,28800,14,82,11,77,3,5,0.25071180555555556,1
MTURK,112a14c770ec5b7f907fd95b5c13c,308KJXFUJQ58MC3AK8JWF2KRVN7TAD,0.25,1005.0,Aristo,28800,6,79,6,81,0,-2,0.2506857638888889,1
MTURK,112a14c770ec5b7f907fd95b5c13c,3NRZ1LDP7V5BVSIBFJQBRLA3F5TZPF,0.25,1001.0,Aristo,28800,9,97,9,95,0,2,0.2508420138888889,1
MTURK,112a14c770ec5b7f907fd95b5c13c,3NQUW096N576YGL0JT35XGZQVS49LC,0.25,997.0,Aristo,28800,11,82,11,80,0,2,0.25071180555555556,1
MTURK,112a14c770ec5b7f907fd95b5c13c,3YLTXLH3DE5P47IH9XK4RE6YJFCPHF,0.25,965.0,Aristo,28800,10,75,10,74,0,1,0.2506510416666667,1
MTURK,112a14c770ec5b7f907fd95b5c13c,3WJGKMRWVH8PY24BIWF8GTSTS45CDG,0.25,856.0,Aristo,28800,17,84,17,33,0,51,0.25072916666666667,1
MTURK,112a14c770ec5b7f907fd95b5c13c,3X878VYTIDHGK5NBIL2NO73036U7FT,0.25,861.0,Aristo,28800,7,99,7,9,0,90,0.250859375,1
MTURK,112a14c770ec5b7f907fd95b5c13c,3FVBZG9CLIDMGQEXSC5ECD5QB710HK,0.25,696.0,Aristo,28800,32,97,32,90,0,7,0.2508420138888889,1
MTURK,112a14c770ec5b7f907fd95b5c13c,3SBX2M1TKCMGS7V1U3FAXUN4J6D4Q0,0.25,557.0,Aristo,28800,34,79,34,72,0,7,0.2506857638888889,1
MTURK,112a14c770ec5b7f907fd95b5c13c,3UEBBGULPENIIGZ7VTVYYZHKBHSFU4,0.25,554.0,Aristo,28800,32,65,32,59,0,6,0.2505642361111111,1
MTURK,112a14c770ec5b7f907fd95b5c13c,311HQEI8RRFMPMEBJXWURZJIFBO7ZH,0.25,555.0,Aristo,28800,34,74,34,69,0,5,0.2506423611111111,1
MTURK,112a14c770ec5b7f907fd95b5c13c,3J6BHNX0U8RG3C7CZ3A90HHVBHGNKM,0.25,550.0,Aristo,28800,32,80,32,39,0,41,0.25069444444444444,1
MTURK,112a14c770ec5b7f907fd95b5c13c,30OITAWPBP24CK2AS8O75O6JEBV9H5,0.25,551.0,Aristo,28800,28,80,28,34,0,46,0.25069444444444444,1
MTURK,112a14c770ec5b7f907fd95b5c13c,341YLJU21HYT8VSVDHRDVDZK8I02IZ,0.25,548.0,Aristo,28800,24,66,24,57,0,9,0.25057291666666665,1
MTURK,112a14c770ec5b7f907fd95b5c13c,3AA88CN98O2AFBBQ65JKHXF2F1KKY9,0.25,550.0,Aristo,28800,28,58,28,52,0,6,0.25050347222222225,1
MTURK,112a14c770ec5b7f907fd95b5c13c,3H4IKZHALAHHBISFWG2PS9YZ5CLNNR,0.25,546.0,Aristo,28800,33,75,33,38,0,37,0.2506510416666667,1
MTURK,112a14c770ec5b7f907fd95b5c13c,37PGLWGSJS5OPBWL2NXHV9LEPIMIK1,0.25,546.0,Aristo,28800,26,44,26,13,0,31,0.25038194444444445,1
MTURK,112a14c770ec5b7f907fd95b5c13c,366FYU4PTFOC96UZ647QAUNMXPFKEU,0.25,547.0,Aristo,28800,40,91,40,84,0,7,0.25078993055555554,1
MTURK,112a14c770ec5b7f907fd95b5c13c,3INZSNUD8ZPN04X86C5HE3RLMJ2D90,0.25,546.0,Aristo,28800,32,55,32,30,0,25,0.25047743055555555,1
MTURK,112a14c770ec5b7f907fd95b5c13c,3FBEFUUYRJ42KESYOVB34SSDBFXA6K,0.25,546.0,Aristo,28800,39,67,39,61,0,6,0.25058159722222223,1
MTURK,112a14c770ec5b7f907fd95b5c13c,3E22YV8GG05HE34SCVFHWY3U5RMNPN,0.25,543.0,Aristo,28800,38,60,38,54,0,6,0.25052083333333336,1
MTURK,112a14c770ec5b7f907fd95b5c13c,38Z7YZ2SB21A0EUGFSHERVXNOODQI0,0.25,538.0,Aristo,28800,39,73,39,29,0,44,0.25063368055555557,1
MTURK,112a14c770ec5b7f907fd95b5c13c,3IQ9O0AYW5YNSUM8WWB9W08A8VDIT7,0.25,545.0,Aristo,28800,40,107,40,60,0,47,0.25092881944444445,1
MTURK,112a14c770ec5b7f907fd95b5c13c,3421H3BM99G03QX0G8RSH1MYR3Z9JA,0.25,530.0,Aristo,28800,32,70,32,18,0,52,0.2506076388888889,1
MTURK,112a14c770ec5b7f907fd95b5c13c,3VI0PC2ZAXJ45X6VZ1PB50P2X0ZOXQ,0.25,518.0,Aristo,28800,39,70,39,57,0,13,0.2506076388888889,1
MTURK,112a14c770ec5b7f907fd95b5c13c,36JW4WBR05JDDUTNVUOZFKSUH9QFH3,0.25,515.0,Aristo,28800,41,104,41,51,0,53,0.25090277777777775,1
MTURK,112a14c770ec5b7f907fd95b5c13c,3VQTAXTYN2KS5ZNRQR92F9QZWJZUB0,0.25,519.0,Aristo,28800,20,73,20,23,0,50,0.25063368055555557,1
MTURK,112a14c770ec5b7f907fd95b5c13c,3LOJFQ4BOWE7H0GZA9W64C51XDEDKU,0.25,511.0,Aristo,28800,41,120,41,112,0,8,0.25104166666666666,1
MTURK,112a14c770ec5b7f907fd95b5c13c,32PT7WK7DLE1L28SP347NQOZMRSD3J,0.25,518.0,Aristo,28800,42,86,40,67,2,19,0.2507465277777778,1
MTURK,112a14c770ec5b7f907fd95b5c13c,3CKVGCS3PF4B6ZSD36HDGRCSKII0S5,0.25,499.0,Aristo,28800,35,117,35,77,0,40,0.251015625,1
MTURK,112a14c770ec5b7f907fd95b5c13c,31MCUE39BJL4XMIJRT5FTBRWZJ83GJ,0.25,507.0,Aristo,28800,32,75,32,69,0,6,0.2506510416666667,1
MTURK,112a14c770ec5b7f907fd95b5c13c,33NKDW9FFWH3W89S9WGKA0VL8MHCXI,0.25,507.0,Aristo,28800,38,56,38,38,0,18,0.25048611111111113,1
MTURK,112a14c770ec5b7f907fd95b5c13c,3WRAAIUSBIYF3TCUPIKT455X8JVXA0,0.25,502.0,Aristo,28800,38,63,38,53,0,10,0.250546875,1
MTURK,112a14c770ec5b7f907fd95b5c13c,3TKXBROM5S9TERQ3K2X5UUL1ATLIJ1,0.25,498.0,Aristo,28800,32,65,32,57,0,8,0.2505642361111111,1
MTURK,112a14c770ec5b7f907fd95b5c13c,36BTXXLZ2U7G48A17I4A2KX9FSF4R1,0.25,496.0,Aristo,28800,33,96,33,84,0,12,0.25083333333333335,1
MTURK,112a14c770ec5b7f907fd95b5c13c,3ABAOCJ4R73WWXK707F6JO445XXMQC,0.25,483.0,Aristo,28800,33,80,33,46,0,34,0.25069444444444444,1
MTURK,112a14c770ec5b7f907fd95b5c13c,3TX9T2ZCB801F1FCR546JFIZ82WWZ7,0.25,495.0,Aristo,28800,42,88,42,50,0,38,0.2507638888888889,1
MTURK,112a14c770ec5b7f907fd95b5c13c,3HXK2V1N4JEFC4M0NTRAA1M4T58G2L,0.25,500.0,Aristo,28800,42,83,42,72,0,11,0.2507204861111111,1
MTURK,112a14c770ec5b7f907fd95b5c13c,3MVY4USGB5MMDU9T7W6JMVCO6CZISI,0.25,504.0,Aristo,28800,42,78,42,69,0,9,0.25067708333333333,1
MTURK,112a14c770ec5b7f907fd95b5c13c,3YKP7CX6G1EQ7OBVDJGR5HCFO827BB,0.25,503.0,Aristo,28800,41,100,38,84,3,16,0.2508680555555556,1
MTURK,112a14c770ec5b7f907fd95b5c13c,3SD15I2WD1T20TTDFGWTHKE755563K,0.25,501.0,Aristo,28800,39,78,39,26,0,52,0.25067708333333333,1
MTURK,112a14c770ec5b7f907fd95b5c13c,3DIIW4IV8OU3B97IHVA1OSWISWWI4B,0.25,500.0,Aristo,28800,53,99,47,45,6,54,0.250859375,1
MTURK,112a14c770ec5b7f907fd95b5c13c,33IXYHIZB4HHSQQ9HY1MAY1SGPTE22,0.25,499.0,Aristo,28800,40,92,40,73,0,19,0.2507986111111111,1
MTURK,112a14c770ec5b7f907fd95b5c13c,3Y40HMYLL0HZI2QSVN1K46HRFMNXUC,0.25,500.0,Aristo,28800,40,102,40,96,0,6,0.2508854166666667,1
MTURK,112a14c770ec5b7f907fd95b5c13c,367O8HRHKF7S5NAEM74FSU251UXS4C,0.25,496.0,Aristo,28800,40,71,40,15,0,56,0.25061631944444446,1
MTURK,112a14c770ec5b7f907fd95b5c13c,31MCUE39BJL4XMIJRT5FTBRWZJ8G3W,0.25,497.0,Aristo,28800,33,66,33,53,0,13,0.25057291666666665,1
MTURK,112a14c770ec5b7f907fd95b5c13c,3V7ICJJAZ9FTO1TCBLIK25S5X6CB4V,0.25,499.0,Aristo,28800,40,76,40,56,0,20,0.2506597222222222,1
MTURK,112a14c770ec5b7f907fd95b5c13c,3BAWBGQGYKY5G291I07R6T6MR0I7VH,0.25,495.0,Aristo,28800,33,72,33,67,0,5,0.250625,1
MTURK,112a14c770ec5b7f907fd95b5c13c,31JUPBOORM36KB2QE1XRXK4FBMML8Z,0.25,492.0,Aristo,28800,38,54,38,32,0,22,0.25046875,1
MTURK,112a14c770ec5b7f907fd95b5c13c,3Y7LTZE0YSLONXQ7W5P51RX2NMLUZ6,0.25,494.0,Aristo,28800,41,99,41,92,0,7,0.250859375,1
MTURK,112a14c770ec5b7f907fd95b5c13c,3U18MJKL1TLYKEVO7QTBCY4N687CNY,0.25,495.0,Aristo,28800,39,79,39,45,0,34,0.2506857638888889,1
MTURK,112a14c770ec5b7f907fd95b5c13c,37S0QRNUFAFB54I7KCONSFI9RMN880,0.25,494.0,Aristo,28800,38,57,38,28,0,29,0.25049479166666666,1
MTURK,112a14c770ec5b7f907fd95b5c13c,3UV0D2KX1LIJ1I5SGN4GLVJQC44F4H,0.25,494.0,Aristo,28800,37,62,37,50,0,12,0.2505381944444444,1
MTURK,112a14c770ec5b7f907fd95b5c13c,306W7JMRYXXU72GENO8XJH8AZS88BZ,0.25,493.0,Aristo,28800,33,65,33,48,0,17,0.2505642361111111,1
MTURK,112a14c770ec5b7f907fd95b5c13c,3TRB893CSI9MY5J6T5856S3C4LUG71,0.25,493.0,Aristo,28800,39,60,39,51,0,9,0.25052083333333336,1
MTURK,112a14c770ec5b7f907fd95b5c13c,3MZ3TAMYTKMACF9GS76EWL7SKAGIRU,0.25,491.0,Aristo,28800,39,77,39,34,0,43,0.2506684027777778,1
MTURK,112a14c770ec5b7f907fd95b5c13c,3RQVKZ7ZRJIWJBBZUQNG4O9BU2P729,0.25,491.0,Aristo,28800,41,80,41,34,0,46,0.25069444444444444,1
MTURK,112a14c770ec5b7f907fd95b5c13c,3SR6AEG6W4SJDLAI0KGN45ZANKGHY2,0.25,485.0,Aristo,28800,40,76,40,27,0,49,0.2506597222222222,1
MTURK,112a14c770ec5b7f907fd95b5c13c,3WJGKMRWVH8PY24BIWF8GTSTS45DCH,0.25,487.0,Aristo,28800,38,71,38,67,0,4,0.25061631944444446,1
MTURK,112a14c770ec5b7f907fd95b5c13c,363A7XIFV3LNZ47ZP3JBGK8CS8OAVB,0.25,483.0,Aristo,28800,41,72,41,55,0,17,0.250625,1
MTURK,112a14c770ec5b7f907fd95b5c13c,36FQTHX3Z2Q865A8B7D1S00ZJ6GB3A,0.25,479.0,Aristo,28800,40,66,40,61,0,5,0.25057291666666665,1
MTURK,112a14c770ec5b7f907fd95b5c13c,3RIHDBQ1NDXJJ4L4HHSCAAC3EA2HMC,0.25,482.0,Aristo,28800,28,67,28,56,0,11,0.25058159722222223,1
MTURK,112a14c770ec5b7f907fd95b5c13c,3J9UN9O9J2RI7W9NGC8ZOQL5OZ5J08,0.25,479.0,Aristo,28800,38,61,38,55,0,6,0.2505295138888889,1
MTURK,112a14c770ec5b7f907fd95b5c13c,3CMV9YRYP20V4SY955UIMADTRXGLJJ,0.25,476.0,Aristo,28800,39,68,39,25,0,43,0.25059027777777776,1
MTURK,112a14c770ec5b7f907fd95b5c13c,3OREP8RUT1A90HMW6MKLBUP8NBLGBN,0.25,482.0,Aristo,28800,43,79,43,32,0,47,0.2506857638888889,1
MTURK,112a14c770ec5b7f907fd95b5c13c,3JGHED38ECQMKW46NBUBDSAG9HK7YQ,0.25,469.0,Aristo,28800,40,98,40,41,0,57,0.25085069444444447,1
MTURK,112a14c770ec5b7f907fd95b5c13c,3KQC8JMJGBRIXIDUBZNXEB3XEJL3HI,0.25,469.0,Aristo,28800,40,88,40,81,0,7,0.2507638888888889,1
MTURK,112a14c770ec5b7f907fd95b5c13c,3YKP7CX6G1EQ7OBVDJGR5HCFO82B7F,0.25,467.0,Aristo,28800,45,98,45,91,0,7,0.25085069444444447,1
MTURK,112a14c770ec5b7f907fd95b5c13c,37VE3DA4YTGN0DH7QS23WU192BXHBM,0.25,460.0,Aristo,28800,31,51,31,20,0,31,0.2504427083333333,1
MTURK,112a14c770ec5b7f907fd95b5c13c,39RRBHZ0AT0O0CF71VZAXDZL1TUZV0,0.25,456.0,Aristo,28800,34,60,34,54,0,6,0.25052083333333336,1
MTURK,112a14c770ec5b7f907fd95b5c13c,3SNR5F7R91SL3B4B61MEXE895LQIEH,0.25,464.0,Aristo,28800,51,104,46,62,5,42,0.25090277777777775,1
MTURK,112a14c770ec5b7f907fd95b5c13c,30U1YOGZG9V55JT7FI58VYWBE7RDSB,0.25,454.0,Aristo,28800,38,73,38,65,0,8,0.25063368055555557,1
MTURK,112a14c770ec5b7f907fd95b5c13c,36GJS3V78UPFI0K8UEX29I8LVGUGJ8,0.25,450.0,Aristo,28800,63,126,47,83,16,43,0.25109375,1
MTURK,112a14c770ec5b7f907fd95b5c13c,31D0ZWOD09Y7636JM6VMVRIMYCBA0J,0.25,452.0,Aristo,28800,31,67,31,57,0,10,0.25058159722222223,1
MTURK,112a14c770ec5b7f907fd95b5c13c,3TTPFEFXCSJHU10CU1LVLEFHOAN6HR,0.25,452.0,Aristo,28800,34,69,34,64,0,5,0.25059895833333334,1
MTURK,112a14c770ec5b7f907fd95b5c13c,3W3RSPVVGRQ4I893H4YWTCM48DELUF,0.25,446.0,Aristo,28800,40,75,40,33,0,42,0.2506510416666667,1
MTURK,112a14c770ec5b7f907fd95b5c13c,38VTL6WC49C7XSQNZIFEF8WKIBP5Y9,0.25,428.0,Aristo,28800,42,79,42,34,0,45,0.2506857638888889,1
MTURK,112a14c770ec5b7f907fd95b5c13c,3P6ENY9P78VXNLVDW2UKIH5MX1IIHX,0.25,433.0,Aristo,28800,42,123,42,97,0,26,0.2510677083333333,1
MTURK,112a14c770ec5b7f907fd95b5c13c,3JMNNNO3B03B9QC02YVSW48SNTY2W6,0.25,386.0,Aristo,28800,37,1737,35,1694,2,43,0.265078125,1
MTURK,112a14c770ec5b7f907fd95b5c13c,3FCO4VKOZ3COERNFNAIH6PI0R5FE7I,0.25,370.0,Aristo,28800,26,100,26,83,0,17,0.2508680555555556,1
MTURK,112a14c770ec5b7f907fd95b5c13c,3MA5N0ATTBA6Q6GQR41WW0UM4TKKWA,0.25,372.0,Aristo,28800,26,102,26,91,0,11,0.2508854166666667,1
MTURK,112a14c770ec5b7f907fd95b5c13c,388FBO7JZQSBNHWT3IB09PW69WPNYH,0.25,380.0,Aristo,28800,28,103,28,92,0,11,0.2508940972222222,1
MTURK,112a14c770ec5b7f907fd95b5c13c,37VHPF5VYB2DH78K1O4SU1ESHD8C8A,0.25,372.0,Aristo,28800,26,63,26,50,0,13,0.250546875,1
MTURK,112a14c770ec5b7f907fd95b5c13c,33Q5P9PUSOLS1397AE457LBWGMFCZF,0.25,369.0,Aristo,28800,28,98,26,75,2,23,0.25085069444444447,1
MTURK,112a14c770ec5b7f907fd95b5c13c,3UXQ63NLA9LPM90XHDH1OMUGJS7LBY,0.25,369.0,Aristo,28800,43,92,43,81,0,11,0.2507986111111111,1
MTURK,112a14c770ec5b7f907fd95b5c13c,3UQ1LLR2697K3ZV5BZH5TBAA1AMLA3,0.25,351.0,Aristo,28800,37,75,37,30,0,45,0.2506510416666667,1
MTURK,112a14c770ec5b7f907fd95b5c13c,31MBOZ6PANQ8WES3VDDWZ60Y1D7LC5,0.25,347.0,Aristo,28800,39,78,39,52,0,26,0.25067708333333333,1
MTURK,112a14c770ec5b7f907fd95b5c13c,3Q9SPIIRWIL0ET74FDO72MRQZHQAWL,0.25,345.0,Aristo,28800,38,83,38,49,0,34,0.2507204861111111,1
MTURK,112a14c770ec5b7f907fd95b5c13c,3MYASTQBG6ATS3EUNEG30YHAWJ6DQM,0.25,353.0,Aristo,28800,40,84,40,43,0,41,0.25072916666666667,1
MTURK,112a14c770ec5b7f907fd95b5c13c,3FO95NVK5BZZ6TCCXJ0S0NDFT8ISRW,0.25,339.0,Aristo,28800,39,78,39,68,0,10,0.25067708333333333,1
MTURK,112a14c770ec5b7f907fd95b5c13c,3P6ENY9P78VXNLVDW2UKIH5MX1IHIW,0.25,315.0,Aristo,28800,35,83,35,57,0,26,0.2507204861111111,1
MTURK,112a14c770ec5b7f907fd95b5c13c,3MNJFORX8A31X19SUSNQQNP4C0Z5FC,0.25,315.0,Aristo,28800,32,54,32,36,0,18,0.25046875,1
MTURK,112a14c770ec5b7f907fd95b5c13c,38B7Q9C28F4OFVITWPX38XHT5XF691,0.25,326.0,Aristo,28800,26,44,26,12,0,32,0.25038194444444445,1
MTURK,112a14c770ec5b7f907fd95b5c13c,3TL87MO8CLOFZQCDMF3X7CL1YQZFLA,0.25,339.0,Aristo,28800,39,59,39,54,0,5,0.2505121527777778,1
MTURK,112a14c770ec5b7f907fd95b5c13c,3V0TR1NRV91O5ROK57IO7U8ZFORA4Z,0.25,330.0,Aristo,28800,38,81,37,50,1,31,0.250703125,1
MTURK,112a14c770ec5b7f907fd95b5c13c,3LN50BUKPUARQ3170IZ2J6Z50WMLPJ,0.25,328.0,Aristo,28800,47,106,44,95,3,11,0.25092013888888887,1
MTURK,112a14c770ec5b7f907fd95b5c13c,3511RHPADUDC2GHMDA3RO1ZK1EALRB,0.25,334.0,Aristo,28800,70,150,69,124,1,26,0.2513020833333333,1
MTURK,112a14c770ec5b7f907fd95b5c13c,3N5YJ55YXF2ARZYQNCXK63EZ65MANU,0.25,337.0,Aristo,28800,89,203,89,177,0,26,0.2517621527777778,1
MTURK,112a14c770ec5b7f907fd95b5c13c,334ZEL5JX5EW9GKW5RJO6S8AILYSON,0.25,330.0,Aristo,28800,107,291,107,258,0,33,0.25252604166666665,1
MTURK,112a14c770ec5b7f907fd95b5c13c,3BFNCI9LYJPL4T7IYQ1LNYE30GP37G,0.25,330.0,Aristo,28800,127,318,127,277,0,41,0.25276041666666665,1
MTURK,112a14c770ec5b7f907fd95b5c13c,3Y3CZJSZ9JSY0RE1LNNK7C3NFOA5R7,0.25,324.0,Aristo,28800,91,247,91,213,0,34,0.2521440972222222,1
MTURK,112a14c770ec5b7f907fd95b5c13c,3JTPR5MTZRBCDN16V3EN60H9KWF5KD,0.25,320.0,Aristo,28800,85,240,85,181,0,59,0.2520833333333333,1
MTURK,112a14c770ec5b7f907fd95b5c13c,3ZXNP4Z39QK2KXX74W5LJK8K02G7LY,0.25,330.0,Aristo,28800,92,236,92,144,0,92,0.2520486111111111,1
MTURK,112a14c770ec5b7f907fd95b5c13c,3KI0JD2ZU0HK1CU0HSZJU1QNA7R76Q,0.25,330.0,Aristo,28800,96,258,96,134,0,124,0.25223958333333335,1
MTURK,112a14c770ec5b7f907fd95b5c13c,30Z7M1Q8UXJPOSBMHA81O6O4HAN8A4,0.25,330.0,Aristo,28800,109,284,104,135,5,149,0.2524652777777778,1
MTURK,112a14c770ec5b7f907fd95b5c13c,371QPA24C1NCSOQAOPQ341RORT1T1P,0.25,323.0,Aristo,28800,113,290,107,137,6,153,0.2525173611111111,1
MTURK,112a14c770ec5b7f907fd95b5c13c,32L724R85KJP02T1FF2PRQ7DJSSIP2,0.25,320.0,Aristo,28800,113,285,107,167,6,118,0.25247395833333336,1
MTURK,112a14c770ec5b7f907fd95b5c13c,36818Z1KV2C3NV5G5TD5XPGT1OVA3E,0.25,318.0,Aristo,28800,123,320,117,234,6,86,0.25277777777777777,1
MTURK,112a14c770ec5b7f907fd95b5c13c,3ZUE82NE090KKJSUSQUT27ZVEQ0F8O,0.25,330.0,Aristo,28800,102,271,101,171,1,100,0.25235243055555556,1
MTURK,112a14c770ec5b7f907fd95b5c13c,3VP28W7DUMJZ4FTH1GU6FRWZDZ7FZT,0.25,305.0,Aristo,28800,106,273,106,200,0,73,0.2523697916666667,1
MTURK,112a14c770ec5b7f907fd95b5c13c,3UEDKCTP9UPR0RFPJWTK4KV5B2B7KV,0.25,320.0,Aristo,28800,104,274,104,197,0,77,0.2523784722222222,1
MTURK,112a14c770ec5b7f907fd95b5c13c,3A520CCNWMZ6XTLDUDU1GGKQSDLEA9,0.25,319.0,Aristo,28800,100,220,100,128,0,92,0.25190972222222224,1
MTURK,112a14c770ec5b7f907fd95b5c13c,32TMVRKDGMXAM3V589YAB324P0R84T,0.25,293.0,Aristo,28800,121,249,113,181,8,68,0.2521614583333333,1
MTURK,112a14c770ec5b7f907fd95b5c13c,3ZRKL6Z1E728H33YH86G1JZ8RZ6SGZ,0.25,294.0,Aristo,28800,116,215,108,140,8,75,0.25186631944444443,1
MTURK,112a14c770ec5b7f907fd95b5c13c,32204AGAAABJRUPI6EUHX5S6IOQGH3,0.25,312.0,Aristo,28800,121,234,113,157,8,77,0.25203125,1
MTURK,112a14c770ec5b7f907fd95b5c13c,3S8APUMBJWI3MHQ1V2E3T9PWMWLFBN,0.25,302.0,Aristo,28800,129,217,121,137,8,80,0.25188368055555554,1
MTURK,112a14c770ec5b7f907fd95b5c13c,3P7RGTLO6DC9JTDNQZ54EBXVCAHAKP,0.25,292.0,Aristo,28800,103,231,103,170,0,61,0.25200520833333334,1
MTURK,112a14c770ec5b7f907fd95b5c13c,3QREJ3J432WQFC4RNQUUNPD66MGKLH,0.25,283.0,Aristo,28800,118,283,114,206,4,77,0.25245659722222225,1
MTURK,112a14c770ec5b7f907fd95b5c13c,31S7M7DAGFPPIVUEHZ8MOG02PZ7LTO,0.25,305.0,Aristo,28800,118,259,114,172,4,87,0.2522482638888889,1
MTURK,112a14c770ec5b7f907fd95b5c13c,3URJ6VVYUOMD7VILFQN68PS445VO4C,0.25,269.0,Aristo,28800,133,273,129,205,4,68,0.2523697916666667,1
MTURK,112a14c770ec5b7f907fd95b5c13c,375VMB7D4IIGB5QBA6BURWQO59PDIJ,0.25,270.0,Aristo,28800,117,232,113,154,4,78,0.25201388888888887,1
MTURK,112a14c770ec5b7f907fd95b5c13c,3D4BBDG7ZGVRGA2EP79W3K6H1RG3C9,0.25,268.0,Aristo,28800,108,205,108,145,0,60,0.25177951388888886,1
MTURK,112a14c770ec5b7f907fd95b5c13c,3JMQI2OLFY48P6127MOMW4M5R8JDNZ,0.25,284.0,Aristo,28800,106,223,106,173,0,50,0.2519357638888889,1
MTURK,112a14c770ec5b7f907fd95b5c13c,35XW21VSVFDO3VHZSZ3WEB4GNGTLSZ,0.25,264.0,Aristo,28800,110,236,110,187,0,49,0.2520486111111111,1
MTURK,112a14c770ec5b7f907fd95b5c13c,31JUPBOORM36KB2QE1XRXK4FBMM8LM,0.25,277.0,Aristo,28800,91,249,91,243,0,6,0.2521614583333333,1
MTURK,112a14c770ec5b7f907fd95b5c13c,3P4ZBJFX2U2VAKOCQTAZGN2HWX3FW3,0.25,0.0,Aristo,28800,609,2016,588,1636,21,380,0.2675,1
MTURK,112a14c770ec5b7f907fd95b5c13c,3G9UA71JVUTWP7971BT835VSWDB7JW,0.25,0.0,Aristo,28800,607,2018,586,1699,21,319,0.26751736111111113,1
MTURK,112a14c770ec5b7f907fd95b5c13c,3C8QQOM6JO0Z9HE3NN9IA9YTEIRLI7,0.25,0.0,Aristo,28800,618,2057,589,1560,29,497,0.26785590277777777,1
MTURK,112a14c770ec5b7f907fd95b5c13c,3JUDR1D0D5Q6PTGEQPWM4FQ6ZSHQ2Q,0.25,85.0,Aristo,28800,266,809,259,718,7,91,0.25702256944444446,1
MTURK,112a14c770ec5b7f907fd95b5c13c,35ZRNT9RUHXSPZZHFCINYK0YQ5ZO3R,0.25,36.0,Aristo,28800,280,917,274,815,6,102,0.25796006944444444,1
MTURK,112a14c770ec5b7f907fd95b5c13c,3K3G488TR17YOQZ188YK2MTIJ28Q5R,0.25,17.0,Aristo,28800,309,1033,303,863,6,170,0.2589670138888889,1
MTURK,112a14c770ec5b7f907fd95b5c13c,3THR0FZ95OS953P6LIMNU6UFQRQLO2,0.25,51.0,Aristo,28800,298,977,292,844,6,133,0.2584809027777778,1
MTURK,112a14c770ec5b7f907fd95b5c13c,3ECKRY5B1PVJE6V72O0RIO9RTRZIZN,0.25,0.0,Aristo,28800,292,543,287,396,5,147,0.25471354166666665,1
MTURK,112a14c770ec5b7f907fd95b5c13c,3UUIU9GZC44BG6RTPCSF7R453975TK,0.25,0.0,Aristo,28800,294,594,289,442,5,152,0.25515625,1
MTURK,112a14c770ec5b7f907fd95b5c13c,3GS542CVJUMSWRIFR6NYGR3T92459K,0.25,0.0,Aristo,28800,402,1289,396,1070,6,219,0.2611892361111111,1
MTURK,112a14c770ec5b7f907fd95b5c13c,3HYV4299HZVSE5SYXFANKPEV2PLE85,0.25,0.0,Aristo,28800,387,1232,381,1023,6,209,0.26069444444444445,1
MTURK,112a14c770ec5b7f907fd95b5c13c,38Z7YZ2SB21A0EUGFSHERVXNOOEIQT,0.25,0.0,Aristo,28800,415,1347,409,1094,6,253,0.26169270833333336,1
MTURK,112a14c770ec5b7f907fd95b5c13c,3MDWE879UG1UL7ZOSGEBJD3LJYQB9R,0.25,0.0,Aristo,28800,331,782,326,552,5,230,0.25678819444444445,1
MTURK,112a14c770ec5b7f907fd95b5c13c,3SSN80MU8BNLF6LG19XIYJ8TDVQKX3,0.25,0.0,Aristo,28800,1198,3308,1173,2438,25,870,0.27871527777777777,1
MTURK,112a14c770ec5b7f907fd95b5c13c,3VGZ74AYTFFSAME2KMGGMEVQ5WLGCU,0.25,0.0,Aristo,28800,479,1552,460,1185,19,367,0.2634722222222222,1
MTURK,112a14c770ec5b7f907fd95b5c13c,3R15W654VCSCQF2M0VERJBPF5S8LQA,0.25,0.0,Aristo,28800,492,1671,472,1244,20,427,0.26450520833333335,1
MTURK,112a14c770ec5b7f907fd95b5c13c,3JMQI2OLFY48P6127MOMW4M5R8JND9,0.25,0.0,Aristo,28800,362,1084,343,703,19,381,0.25940972222222225,1
MTURK,112a14c770ec5b7f907fd95b5c13c,35O6H0UNLRFH23VODIEB5LHW57G5JF,0.25,0.0,Aristo,28800,345,1234,323,819,22,415,0.26071180555555556,1
MTURK,112a14c770ec5b7f907fd95b5c13c,3K8CQCU3KD07YC1TOHTCOSBQYOPNWI,0.25,0.0,Aristo,28800,343,1192,321,779,22,413,0.26034722222222223,1
MTURK,112a14c770ec5b7f907fd95b5c13c,3WRBLBQ2GQ78GUJM86NWRDTPW7OG01,0.25,0.0,Aristo,28800,346,1192,324,803,22,389,0.26034722222222223,1
MTURK,112a14c770ec5b7f907fd95b5c13c,3B9XR6P1WDUJRJCXES5O87HOF32JBU,0.25,0.0,Aristo,28800,268,486,263,344,5,142,0.25421875,1
MTURK,112a14c770ec5b7f907fd95b5c13c,3EPG8DX9LJPDOEYM8VJV2H38E6M5PF,0.25,0.0,Aristo,28800,361,1269,328,853,33,416,0.261015625,1
MTURK,112a14c770ec5b7f907fd95b5c13c,3NQUW096N576YGL0JT35XGZQVS4L9O,0.25,0.0,Aristo,28800,286,1027,264,662,22,365,0.25891493055555553,1
MTURK,112a14c770ec5b7f907fd95b5c13c,3W0KKJIARQ8V05K8T1LQIKR0MMH8KJ,0.25,0.0,Aristo,28800,308,1112,276,729,32,383,0.2596527777777778,1
MTURK,112a14c770ec5b7f907fd95b5c13c,324N5FAHSXGSA7SB1ALMC2BJ56VKVV,1.0,1.0,Rellie Rozin,1800,107,795,9,36,98,759,1.4416666666666667,1
MTURK,112a14c770ec5b7f907fd95b5c13c,3CVBMEMMXBGVIN8B9ASVLKB2R4TH70,0.2,112.0,SurveyComet,600,29,107,13,67,16,40,0.2356666666666667,1
MTURK,112a14c770ec5b7f907fd95b5c13c,3VP28W7DUNKGJGVUUKTTEBXDQDCFZJ,0.8,23.0,Xian Zhao,1800,81,536,12,59,69,477,1.0382222222222222,1
MTURK,112a14c770ec5b7f907fd95b5c13c,3QGTX7BCITP0BHHEQZPYSVT620J5ZT,0.1,1093.0,Peter Ciuffetti,240,54,109,43,64,11,45,0.14541666666666667,1
MTURK,112a14c770ec5b7f907fd95b5c13c,3LCXHSGDMXT36OOT68OT0W2GSEHSEB,0.1,1088.0,Peter Ciuffetti,240,54,92,39,36,15,56,0.13833333333333334,0
MTURK,112a14c770ec5b7f907fd95b5c13c,3OPLMF3EU4MRNIPUK3MAFHUA0JLLNR,0.17,963.0,Aristo,3600,23,119,23,111,0,8,0.17561944444444447,1
MTURK,112a14c770ec5b7f907fd95b5c13c,3UQ1LLR2697K3ZV5BZH5TBAA1CMLA7,0.17,960.0,Aristo,3600,57,149,52,132,5,17,0.17703611111111112,1
MTURK,112a14c770ec5b7f907fd95b5c13c,3PCPFX4U4ZPQQNSQEKBTOYKV8YMFQ3,0.17,959.0,Aristo,3600,42,86,42,53,0,33,0.1740611111111111,1
MTURK,112a14c770ec5b7f907fd95b5c13c,36FQTHX3Z2Q865A8B7D1S00ZJ8GB3E,0.17,957.0,Aristo,3600,42,100,41,74,1,26,0.17472222222222222,1
MTURK,112a14c770ec5b7f907fd95b5c13c,30ZKOOGW2V5JGX6ORBLH70XRMMC1A2,0.75,1.0,Sean Kelstrom,3600,65,306,34,45,31,261,0.81375,1
MTURK,112a14c770ec5b7f907fd95b5c13c,3E9ZFLPWOZS96QC9E5MEGKD4A8UIX1,1.2,1.0,Eric Bogert,600,79,626,37,309,42,317,2.452,1
MTURK,112a14c770ec5b7f907fd95b5c13c,3UQVX1UPFSTJ9QKVFOJKE0AHDXY20D,3.0,4.0,Zhiping Mao,10800,35,811,21,295,14,516,3.225277777777778,1
MTURK,112a14c770ec5b7f907fd95b5c13c,3PN6H8C9R5QEYZY9A2F9I88A36VAD7,1.0,1.0,apollo,1800,71,208,24,35,47,173,1.1155555555555556,1
MTURK,112a14c770ec5b7f907fd95b5c13c,307FVKVSZUSKQBKHAATPSH0YRVA47L,0.5,1.0,UPenn Researcher,3600,68,544,28,66,40,478,0.5755555555555556,1
MTURK,112a14c770ec5b7f907fd95b5c13c,3B6F54KMR2N1FT7D8L0H49979NYS1W,1.0,1.0,Albert Lee,2700,25,51,17,20,8,31,1.018888888888889,1
MTURK,112a14c770ec5b7f907fd95b5c13c,3GITHABAD1DXPZSEHULIQP6XEQ3N2S,1.0,1.0,Niklas Kühsel,3600,178,926,21,41,157,885,1.2572222222222222,1
MTURK,112a14c770ec5b7f907fd95b5c13c,3DWNFENNE2UZMPXSC3L4QEB0PLAJ46,0.36,100.0,Stanford GSB Behavioral Lab,1200,47,301,12,15,35,286,0.4503,1
MTURK,112a14c770ec5b7f907fd95b5c13c,3VLL1PIEOT171UG2P4VXAUWB22BZO9,0.1,19.0,Center for Decision Research (SJC),2700,46,218,13,15,33,203,0.10807407407407407,1
MTURK,112a14c770ec5b7f907fd95b5c13c,3UXQ63NLACAS1GYB8IEJJC3KH9YLBV,2.75,25.0,Noah Turk,1800,17,85,12,54,5,31,2.879861111111111,1
MTURK,112a14c770ec5b7f907fd95b5c13c,3R15W654VDPG5EA716M2OO7E2XYLQX,0.5,1.0,Goldberg Imports,86400,107,207,42,77,65,130,0.5011979166666667,1
MTURK,112a14c770ec5b7f907fd95b5c13c,32XN26MTXZJPYLI51J21HFYXDJUL0A,3.0,1.0,David Cheng,7200,46,764,20,594,26,170,3.3183333333333334,1
MTURK,112a14c770ec5b7f907fd95b5c13c,3OREP8RUU5FW7COGRSUL8JPV33TGBE,0.5,1.0,Daniel Guttentag,7200,35,313,19,240,16,73,0.5217361111111111,1
MTURK,112a14c770ec5b7f907fd95b5c13c,33EEIIWHLBGP2AJK51MHNQ5QEVRQVJ,2.0,1.0,Laura,172800,46,89,22,48,24,41,2.001030092592593,0
MTURK,112a14c770ec5b7f907fd95b5c13c,3RHLQY6EEW2CVF2P84ZYS2ZN7K6D4H,0.1,2370.0,Roy Valler,3600,83,83,57,59,26,24,0.10230555555555557,0
MTURK,112a14c770ec5b7f907fd95b5c13c,3D5G8J4N5COIZQ2XJANI4EOUSCLVTP,2.5,1.0,Teju Herath,3600,25,1050,18,992,7,58,3.229166666666667,1
MTURK,112a14c770ec5b7f907fd95b5c13c,3087LXLJ6NLQW9NFYJQF4K4G3G0F0L,0.8,1.0,Jano,3600,35,786,22,243,13,543,0.9746666666666667,1
MTURK,112a14c770ec5b7f907fd95b5c13c,3B623HUYJ4Q803FHBNDKUQWIMU48SX,2.0,1.0,Michael A Xenos,1800,66,688,20,76,46,612,2.7644444444444445,1
MTURK,112a14c770ec5b7f907fd95b5c13c,391FPZIE4CMH3TO1EWOCR0SG164HU7,0.5,1.0,The Wharton School,1800,50,368,15,13,35,355,0.6022222222222222,1
MTURK,112a14c770ec5b7f907fd95b5c13c,3N7PQ0KLJ9S0M1P7TQD5OK0KFBD3EL,1.0,1006.0,AQUX,3600,23,1374,14,28,9,1346,1.3816666666666666,1
MTURK,112a14c770ec5b7f907fd95b5c13c,338431Z1FNSDK5H5C9J7Y26ZTXBROL,15.0,0.0,Ricarda Pritschmann,10800,488,3176,22,33,466,3143,19.41111111111111,1
MTURK,112a14c770ec5b7f907fd95b5c13c,3M93N4X8IO91DVULG4UKEWTJNHBJSG,10.0,1.0,R4P,7200,733,3418,180,355,553,3063,14.747222222222224,0
MTURK,112a14c770ec5b7f907fd95b5c13c,3G5RUKN2FFX4Y3YZU296KIU0QKON9K,2.0,0.0,rasa-research,1800,146,1336,16,43,130,1293,3.4844444444444447,1
MTURK,112a14c770ec5b7f907fd95b5c13c,3THR0FZ96SNHHQZKKEC94GL0GOALOU,1.2,509.0,rasa-research,7200,23,38,11,23,12,15,1.2063333333333333,0
MTURK,112a14c770ec5b7f907fd95b5c13c,3N5YJ55YYKBWOBA4CFUK1FPH783ANL,1.0,1.0,Robert Jensen,3600,160,503,35,69,125,434,1.1397222222222223,0
MTURK,112a14c770ec5b7f907fd95b5c13c,3Z3R5YC0P34X5VJVTM4P9N6KJFYFT3,0.75,1.0,James Bisbee,3600,59,218,18,13,41,205,0.7954166666666667,1
MTURK,112a14c770ec5b7f907fd95b5c13c,31GN6YMHLPS0RB45LJSLX3K3QRPWSR,1.0,1.0,Khudejah,3600,139,558,18,37,121,521,1.155,1
MTURK,112a14c770ec5b7f907fd95b5c13c,32TZXEA1OKJSB3BK9OPVWTFWB1X14S,0.21,550.0,Aristo,3600,41,177,41,169,0,8,0.220325,1
MTURK,112a14c770ec5b7f907fd95b5c13c,30F94FBDNQJD5M82QMJSAD4XDC5TBZ,0.21,550.0,Aristo,3600,37,113,37,97,0,16,0.21659166666666665,1
MTURK,112a14c770ec5b7f907fd95b5c13c,3XBXDSS887IWZC3YM99JDJL8227LXX,0.21,550.0,Aristo,3600,38,137,38,122,0,15,0.21799166666666667,1
MTURK,112a14c770ec5b7f907fd95b5c13c,37ZQELHEQZXBT07FKFNPFU9Z0TNNMH,0.21,550.0,Aristo,3600,33,111,33,65,0,46,0.216475,1
MTURK,112a14c770ec5b7f907fd95b5c13c,3HFWPF5AK8I7NRRAMTZWIPAZN1E3ST,0.21,550.0,Aristo,3600,39,82,39,54,0,28,0.21478333333333333,1
MTURK,112a14c770ec5b7f907fd95b5c13c,3WRKFXQBOA6J9GL262Y84H0PN47YI2,0.21,550.0,Aristo,3600,34,146,34,109,0,37,0.21851666666666666,1
MTURK,112a14c770ec5b7f907fd95b5c13c,34F34TZU7VYP36C1VZCD7EEKL41J2I,0.21,550.0,Aristo,3600,37,47,37,27,0,20,0.21274166666666666,1
MTURK,112a14c770ec5b7f907fd95b5c13c,3NKW03WTLL6S19EL49LTSM6V36OQWY,0.21,550.0,Aristo,3600,38,122,38,95,0,27,0.21711666666666665,1
MTURK,112a14c770ec5b7f907fd95b5c13c,3ACRLU860MDBG3Q50RUXBR4WA2IEBU,0.21,550.0,Aristo,3600,30,87,30,62,0,25,0.215075,1
MTURK,112a14c770ec5b7f907fd95b5c13c,3L7SUC0TTTT884F8J9LR4IDMS0CM05,0.21,550.0,Aristo,3600,40,147,40,123,0,24,0.218575,1
MTURK,112a14c770ec5b7f907fd95b5c13c,3ICOHX7ENBAAWGNV2BX8RA8DJYLE08,0.21,550.0,Aristo,3600,42,105,42,94,0,11,0.21612499999999998,1
MTURK,112a14c770ec5b7f907fd95b5c13c,3A3KKYU7P2G1GUGTCGECBDMQT5RWMH,0.21,550.0,Aristo,3600,48,135,48,124,0,11,0.21787499999999999,1
MTURK,112a14c770ec5b7f907fd95b5c13c,3WA2XVDZELG5AR9A40DP0BI4W176E1,0.21,550.0,Aristo,3600,48,113,43,85,5,28,0.21659166666666665,1
MTURK,112a14c770ec5b7f907fd95b5c13c,3OID399FXIWIP49KVPPDMRD98P9FD0,0.6,105.0,L Niemi,3600,32,504,11,44,21,460,0.6839999999999999,1
MTURK,112a14c770ec5b7f907fd95b5c13c,36FFXPMSTAC46H3QRDDPRDS9VMYHO8,0.1,929.0,MLDataLabeler,600,50,100,26,20,24,80,0.11666666666666667,1
MTURK,112a14c770ec5b7f907fd95b5c13c,3B623HUYJ5EQBYUQVQ0SY59BPSB8SH,0.1,896.0,MLDataLabeler,600,46,78,26,15,20,63,0.113,1
MTURK,112a14c770ec5b7f907fd95b5c13c,3Q2T3FD0OOW1C6BFZC9AVF2UHH0M3Q,0.1,915.0,MLDataLabeler,600,31,34,20,8,11,26,0.10566666666666667,1
MTURK,112a14c770ec5b7f907fd95b5c13c,3CVBMEMMXC4XLBBRARWNGR6E5XO7H8,0.1,881.0,MLDataLabeler,600,43,48,31,19,12,29,0.10800000000000001,1
MTURK,112a14c770ec5b7f907fd95b5c13c,3YCT0L9OMNXBE5HU1SPBG2Z6ENASNP,0.1,881.0,MLDataLabeler,600,34,33,24,4,10,29,0.10550000000000001,1
MTURK,112a14c770ec5b7f907fd95b5c13c,3HO4MYYR13CJMX36RGYUTSV84U5U6W,0.1,864.0,MLDataLabeler,600,57,50,42,16,15,34,0.10833333333333334,1
MTURK,112a14c770ec5b7f907fd95b5c13c,3CRWSLD91LSQYV41IAT2JI05C8XOMO,0.1,856.0,MLDataLabeler,600,32,35,24,8,8,27,0.10583333333333333,1
MTURK,112a14c770ec5b7f907fd95b5c13c,31MBOZ6PAPF5JOPDSTJWO5RZNPOLCM,0.1,832.0,MLDataLabeler,600,52,80,38,13,14,67,0.11333333333333334,1
MTURK,112a14c770ec5b7f907fd95b5c13c,3XEIP58NL1BIRH0NK734Z3SKW7ALZL,0.1,832.0,MLDataLabeler,600,33,33,24,12,9,21,0.10550000000000001,1
MTURK,112a14c770ec5b7f907fd95b5c13c,3UXQ63NLABAM9JX7ETN1DLLH54OBL5,0.1,784.0,MLDataLabeler,600,44,45,30,10,14,35,0.10750000000000001,1
MTURK,112a14c770ec5b7f907fd95b5c13c,3BPP3MA3TD8KGM9ROKPRETR2811EL8,0.1,784.0,MLDataLabeler,600,27,35,19,5,8,30,0.10583333333333333,1
MTURK,112a14c770ec5b7f907fd95b5c13c,30EV7DWJTWJ036NB1HVJWD1L0IHY6Z,0.1,741.0,MLDataLabeler,600,26,34,18,3,8,31,0.10566666666666667,1
MTURK,112a14c770ec5b7f907fd95b5c13c,3V0TR1NRVBQLS1LU2NOOWTZ0108A4G,0.1,742.0,MLDataLabeler,600,33,47,24,10,9,37,0.10783333333333334,1
MTURK,112a14c770ec5b7f907fd95b5c13c,3WYZV0QBFK1H9DEWSCQPOFG4CDXXBC,0.1,698.0,MLDataLabeler,600,37,44,25,7,12,37,0.10733333333333334,1
MTURK,112a14c770ec5b7f907fd95b5c13c,3ABAOCJ4R9STJ7HHXNL68NV5R9FQMY,0.1,702.0,MLDataLabeler,600,43,49,33,15,10,34,0.10816666666666667,1
MTURK,112a14c770ec5b7f907fd95b5c13c,3CMV9YRYP4PSR2VJ2L0IB94UD9XJLY,0.1,647.0,MLDataLabeler,600,32,33,24,6,8,27,0.10550000000000001,1
MTURK,112a14c770ec5b7f907fd95b5c13c,37S0QRNUFC48SEFHHSUNHE9ADY488H,0.1,669.0,MLDataLabeler,600,45,43,31,14,14,29,0.10716666666666667,1
MTURK,112a14c770ec5b7f907fd95b5c13c,3LEG2HW4UGB6LENF9PRSHFDTE2PF22,0.1,657.0,MLDataLabeler,600,37,35,27,10,10,25,0.10583333333333333,1
MTURK,112a14c770ec5b7f907fd95b5c13c,38VTL6WC4B14K2NXWYLE47NL4N6Y5J,0.1,626.0,MLDataLabeler,600,37,40,28,5,9,35,0.10666666666666667,1
MTURK,112a14c770ec5b7f907fd95b5c13c,3WYZV0QBFK1H9DEWSCQPOFG4CDYXBD,0.1,600.0,MLDataLabeler,600,43,54,30,4,13,50,0.10900000000000001,1
MTURK,112a14c770ec5b7f907fd95b5c13c,3WA2XVDZEN52X16K1GJPPA95I6CE60,0.1,626.0,MLDataLabeler,600,45,47,31,15,14,32,0.10783333333333334,1
MTURK,112a14c770ec5b7f907fd95b5c13c,341YLJU21JNQV5P5AXXDKCQLUUI2IH,0.1,574.0,MLDataLabeler,600,39,43,28,4,11,39,0.10716666666666667,1
MTURK,112a14c770ec5b7f907fd95b5c13c,3MDKGGG61RB4MKOHRB8KOW96LG06TJ,0.1,550.0,MLDataLabeler,600,62,43,44,2,18,41,0.10716666666666667,1
MTURK,112a14c770ec5b7f907fd95b5c13c,3L7SUC0TTVI5VECIGPRRTH4NE5I0MB,0.1,530.0,MLDataLabeler,600,62,40,44,5,18,35,0.10666666666666667,1
MTURK,112a14c770ec5b7f907fd95b5c13c,3HY86PZXPZ67QF5NVA78UEIOAVX1EQ,0.1,503.0,MLDataLabeler,600,47,31,34,2,13,29,0.10516666666666667,1
MTURK,112a14c770ec5b7f907fd95b5c13c,3DTJ4WT8BE34LBQV3LG0M820NAAEZS,0.1,503.0,MLDataLabeler,600,31,31,24,7,7,24,0.10516666666666667,1
MTURK,112a14c770ec5b7f907fd95b5c13c,3LXX8KJXPXXBRBL7T1PXEWULC9Q9OA,0.1,465.0,MLDataLabeler,600,67,40,47,6,20,34,0.10666666666666667,1
MTURK,112a14c770ec5b7f907fd95b5c13c,32W3UF2EZP99LGISM1KF2OPO13U4CD,0.1,444.0,MLDataLabeler,600,32,32,24,8,8,24,0.10533333333333333,1
MTURK,112a14c770ec5b7f907fd95b5c13c,3909MD9T205YGUZV29MTJGMIB5GEF4,0.1,430.0,MLDataLabeler,600,49,44,33,9,16,35,0.10733333333333334,1
MTURK,112a14c770ec5b7f907fd95b5c13c,3EQVJH0T419KJ98YNUZOLNYWUUGHTV,0.1,355.0,MLDataLabeler,600,28,35,19,6,9,29,0.10583333333333333,1
MTURK,112a14c770ec5b7f907fd95b5c13c,38XPGNCKHUO5KPOSDIFKSGDDMAA4VC,0.1,351.0,MLDataLabeler,600,51,38,36,8,15,30,0.10633333333333334,1
MTURK,112a14c770ec5b7f907fd95b5c13c,33K3E8REWXJY7FGPP06FXDQ347E8XQ,0.1,351.0,MLDataLabeler,600,53,34,38,7,15,27,0.10566666666666667,1
MTURK,112a14c770ec5b7f907fd95b5c13c,33N1S8XHHN951AWJRXLLFOJ6Y161ZW,0.1,274.0,MLDataLabeler,600,38,33,28,6,10,27,0.10550000000000001,1
MTURK,112a14c770ec5b7f907fd95b5c13c,3PZDSVZ3J65SCKFJBRTTIZJ00784NV,0.1,241.0,MLDataLabeler,600,31,45,24,5,7,40,0.10750000000000001,1
MTURK,112a14c770ec5b7f907fd95b5c13c,3HKIF5DF6ZLNZY495ICP9NLJLN09GO,0.1,105.0,MLDataLabeler,600,17,33,13,6,4,27,0.10550000000000001,1
MTURK,112a14c770ec5b7f907fd95b5c13c,39O0SQZVJOVA6U24G68T6NBM8A27R1,0.1,799.0,MLDataLabeler,600,38,38,24,16,14,22,0.10633333333333334,1
MTURK,112a14c770ec5b7f907fd95b5c13c,39KV3A5D19VM792HVV8YWXGIUCL7SP,0.1,775.0,MLDataLabeler,600,65,38,41,3,24,35,0.10633333333333334,1
MTURK,112a14c770ec5b7f907fd95b5c13c,3SR6AEG6W6HGWKK27AMZ5WTDP0DYHW,0.1,775.0,MLDataLabeler,600,59,34,38,3,21,31,0.10566666666666667,1
MTURK,112a14c770ec5b7f907fd95b5c13c,3GITHABACZ9I5VD6HNAH1CP4WXRN2D,0.1,749.0,MLDataLabeler,600,73,41,48,7,25,34,0.10683333333333334,1
MTURK,112a14c770ec5b7f907fd95b5c13c,3NFWQRSHVF2WWX8WIECTVBAW4PAGFI,0.1,749.0,MLDataLabeler,600,57,31,38,6,19,25,0.10516666666666667,1
MTURK,112a14c770ec5b7f907fd95b5c13c,36JW4WBR078AWT372KUBGBMXJPNHFI,0.1,693.0,MLDataLabeler,600,77,49,49,14,28,35,0.10816666666666667,1
MTURK,112a14c770ec5b7f907fd95b5c13c,3P7QK0GJ3U9CMKRPKBLBWZWD6BZZ26,0.1,693.0,MLDataLabeler,600,51,38,33,10,18,28,0.10633333333333334,1
MTURK,112a14c770ec5b7f907fd95b5c13c,3R15W654VEH99EC67LK3K2JI785QLS,0.1,693.0,MLDataLabeler,600,65,52,43,25,22,27,0.10866666666666668,1
MTURK,112a14c770ec5b7f907fd95b5c13c,3W5PY7V3UQVCNQFSVAPKH99S2SHYJ1,0.1,693.0,MLDataLabeler,600,48,40,34,25,14,15,0.10666666666666667,1
MTURK,112a14c770ec5b7f907fd95b5c13c,341H3G5YF125QAOB5OHXDB3Y9DG0ZO,0.1,637.0,MLDataLabeler,600,54,56,40,29,14,27,0.10933333333333334,1
MTURK,112a14c770ec5b7f907fd95b5c13c,3AFT28WXLGQ4Y1RK75VM3HWQB3TOI4,0.1,613.0,MLDataLabeler,600,77,77,51,34,26,43,0.11283333333333334,1
MTURK,112a14c770ec5b7f907fd95b5c13c,30F94FBDNS8AOLIMXCP4B4Y0FLQTBM,0.1,613.0,MLDataLabeler,600,56,37,35,10,21,27,0.10616666666666667,1
MTURK,112a14c770ec5b7f907fd95b5c13c,36QZ6V158A1O5KED83196PU22NJSUD,0.1,528.0,MLDataLabeler,600,151,103,72,27,79,76,0.11716666666666667,1
MTURK,112a14c770ec5b7f907fd95b5c13c,3EHVO81VN69J6E9ZVLFQR9I3IF4H1H,0.1,581.0,MLDataLabeler,600,87,62,40,15,47,47,0.11033333333333334,1
MTURK,112a14c770ec5b7f907fd95b5c13c,3T5ZXGO9DFCTE3TAMMBCSHUGMHDQZB,0.1,528.0,MLDataLabeler,600,64,41,34,8,30,33,0.10683333333333334,1
MTURK,112a14c770ec5b7f907fd95b5c13c,3GV1I4SEOADGZWTMSC65EX2R77U6LC,0.1,518.0,MLDataLabeler,600,63,48,36,17,27,31,0.10800000000000001,1
MTURK,112a14c770ec5b7f907fd95b5c13c,378G7J1SJMM0N5Y028W5ZWBKMCLWEF,0.1,518.0,MLDataLabeler,600,90,63,56,28,34,35,0.1105,1
MTURK,112a14c770ec5b7f907fd95b5c13c,382GHPVPHTFL45ZJ3I9QLDOWBUX43B,0.1,518.0,MLDataLabeler,600,68,40,42,19,26,21,0.10666666666666667,1
MTURK,112a14c770ec5b7f907fd95b5c13c,3XAOZ9UYR0FWJ782EB2K0NA49211QY,0.1,501.0,MLDataLabeler,600,62,48,38,16,24,32,0.10800000000000001,1
MTURK,112a14c770ec5b7f907fd95b5c13c,307FVKVSYS335O065UCGYU0CGWJ74J,0.1,501.0,MLDataLabeler,600,48,41,32,14,16,27,0.10683333333333334,1
MTURK,112a14c770ec5b7f907fd95b5c13c,3VEI3XUCZSLZC064CS2A6927848PRQ,0.1,413.0,MLDataLabeler,600,68,41,44,3,24,38,0.10683333333333334,1
MTURK,112a14c770ec5b7f907fd95b5c13c,3OND0WXMHX3IQF3B79A5YT1X7O8EHX,0.1,413.0,MLDataLabeler,600,86,50,55,6,31,44,0.10833333333333334,1
MTURK,112a14c770ec5b7f907fd95b5c13c,3K8CQCU3KFP4HBBDV7ZOPJ5T04MWN4,0.1,425.0,MLDataLabeler,600,66,42,44,9,22,33,0.10700000000000001,1
MTURK,112a14c770ec5b7f907fd95b5c13c,3SBNLSTU6VTZPUP5H05SSINH32OZDF,0.1,425.0,MLDataLabeler,600,49,32,34,7,15,25,0.10533333333333333,1
MTURK,112a14c770ec5b7f907fd95b5c13c,3BC9H1KCYV0YTAFR298Z6Z304OQYWW,0.1,386.0,MLDataLabeler,600,85,49,55,10,30,39,0.10816666666666667,1
MTURK,112a14c770ec5b7f907fd95b5c13c,368IUKXGA6W6QH8KK4ZCVEBBCHUP6S,0.1,386.0,MLDataLabeler,600,67,36,45,9,22,27,0.10600000000000001,1
MTURK,112a14c770ec5b7f907fd95b5c13c,3MDKGGG61RB4I91R1L8W0OC81KFT61,0.1,344.0,MLDataLabeler,600,66,40,44,14,22,26,0.10666666666666667,1
MTURK,112a14c770ec5b7f907fd95b5c13c,3I7KR83SNB1SX9D25JXGJ7GE88X9KN,0.1,344.0,MLDataLabeler,600,49,32,33,14,16,18,0.10533333333333333,1
MTURK,112a14c770ec5b7f907fd95b5c13c,37SDSEDINAQQD386SHLKEWP4FWF18N,0.1,318.0,MLDataLabeler,600,64,51,41,14,23,37,0.10850000000000001,1
MTURK,112a14c770ec5b7f907fd95b5c13c,3VMV5CHJZ936F2QXDYHICFPXVYITG3,0.1,318.0,MLDataLabeler,600,46,38,31,9,15,29,0.10633333333333334,1
MTURK,112a14c770ec5b7f907fd95b5c13c,3XU80RHWH046M1IN3WE9VIG2PUT44W,0.1,307.0,MLDataLabeler,600,61,48,39,4,22,44,0.10800000000000001,1
MTURK,112a14c770ec5b7f907fd95b5c13c,33NOQL7T9PNN8ZTE0SUC6Q9GSBRZ89,0.1,307.0,MLDataLabeler,600,47,37,32,4,15,33,0.10616666666666667,1
MTURK,112a14c770ec5b7f907fd95b5c13c,3IWA71V4TJ4BZQAB6V9TPRXEEG46XY,0.1,270.0,MLDataLabeler,600,44,50,29,2,15,48,0.10833333333333334,1
MTURK,112a14c770ec5b7f907fd95b5c13c,32CAVSKPCFDOB0FJVKMPAO7TCN71U3,0.1,259.0,MLDataLabeler,600,73,64,46,3,27,61,0.11066666666666668,1
MTURK,112a14c770ec5b7f907fd95b5c13c,3UZUVSO3P8J4IT4MY6QIQY9TOA7EM6,0.1,259.0,MLDataLabeler,600,53,43,33,3,20,40,0.10716666666666667,1
MTURK,112a14c770ec5b7f907fd95b5c13c,39HYCOOPKP9ZQNQM2BFYKGR8OY6MDL,0.1,137.0,MLDataLabeler,600,42,41,26,0,16,41,0.10683333333333334,1
MTURK,112a14c770ec5b7f907fd95b5c13c,3QE4DGPGBSZMYHB7YXGA47D5FZ24GJ,0.1,137.0,MLDataLabeler,600,67,59,40,10,27,49,0.10983333333333334,1
MTURK,112a14c770ec5b7f907fd95b5c13c,3BCRDCM0OEI5FQB47CU4ZXPCI7P6K9,0.1,137.0,MLDataLabeler,600,51,49,31,10,20,39,0.10816666666666667,1
MTURK,112a14c770ec5b7f907fd95b5c13c,3SMIWMMK62THC1VMS8BA3EXN80FWUW,0.1,96.0,MLDataLabeler,600,65,43,41,14,24,29,0.10716666666666667,1
MTURK,112a14c770ec5b7f907fd95b5c13c,3X7837UUBGSLXU5GHXE271MHRZBJ61,1.2,517.0,rasa-research,7200,22,42,11,15,11,27,1.2069999999999999,0
MTURK,112a14c770ec5b7f907fd95b5c13c,38LRF35D5MKKPEGO8E0WMPJOU37U3U,0.1,739.0,MLDataLabeler,600,80,50,41,7,39,43,0.10833333333333334,1
MTURK,112a14c770ec5b7f907fd95b5c13c,3E9ZFLPWOZGRWLS2YMI6A2KH73LXIP,0.1,739.0,MLDataLabeler,600,70,37,35,7,35,30,0.10616666666666667,1
MTURK,112a14c770ec5b7f907fd95b5c13c,3OID399FXHVTOOLV6EB9DY4XBTIFDF,0.1,711.0,MLDataLabeler,600,80,35,54,7,26,28,0.10583333333333333,1
MTURK,112a14c770ec5b7f907fd95b5c13c,3T2HW4QDUWVAIMO43WG6JW04NVBC9K,0.1,711.0,MLDataLabeler,600,96,45,62,8,34,37,0.10750000000000001,1
MTURK,112a14c770ec5b7f907fd95b5c13c,3PR3LXCWSGNYLKZZUSCTX9LEODZ9XJ,0.1,711.0,MLDataLabeler,600,78,44,49,7,29,37,0.10733333333333334,1
MTURK,112a14c770ec5b7f907fd95b5c13c,3KWGG5KP6KQPP67YS5KBOI6ONUICMJ,0.1,711.0,MLDataLabeler,600,63,30,40,1,23,29,0.10500000000000001,1
MTURK,112a14c770ec5b7f907fd95b5c13c,3NFWQRSHVF2W08VM84CHJJ7UOLYFGP,0.1,661.0,MLDataLabeler,600,66,43,43,2,23,41,0.10716666666666667,1
MTURK,112a14c770ec5b7f907fd95b5c13c,311HQEI8RT4JCWBLGD2UGYAJ1N8Z7T,0.1,661.0,MLDataLabeler,600,47,36,30,1,17,35,0.10600000000000001,1
MTURK,112a14c770ec5b7f907fd95b5c13c,3MJ9GGZYO4UBPN67Y9503E22HMG2AG,0.1,576.0,MLDataLabeler,600,49,72,34,24,15,48,0.112,1
MTURK,112a14c770ec5b7f907fd95b5c13c,33Q5P9PUSQAPOD6H7UA5WK2X2Y0CZ0,0.1,576.0,MLDataLabeler,600,66,85,44,25,22,60,0.11416666666666667,1
MTURK,112a14c770ec5b7f907fd95b5c13c,36KM3FWE3S0MAB5VCJP2AZ7XJGQ073,0.1,530.0,MLDataLabeler,600,166,75,87,17,79,58,0.1125,1
MTURK,112a14c770ec5b7f907fd95b5c13c,37PGLWGSJUULCLTVZ33HK8CFBU7KIO,0.1,530.0,MLDataLabeler,600,148,60,76,11,72,49,0.11000000000000001,1
MTURK,112a14c770ec5b7f907fd95b5c13c,3M67TQBQQICMP7R6JIKFD1AGNSQA9G,0.1,501.0,MLDataLabeler,600,76,49,47,7,29,42,0.10816666666666667,1
MTURK,112a14c770ec5b7f907fd95b5c13c,3W9XHF7WGLJBLZ96TF2LYFEOMBNKT5,0.1,501.0,MLDataLabeler,600,61,38,38,3,23,35,0.10633333333333334,1
MTURK,112a14c770ec5b7f907fd95b5c13c,33NOQL7T9PNNCAG4QIU0UY6EC7EZ8G,0.1,501.0,MLDataLabeler,600,78,48,47,10,31,38,0.10800000000000001,1
MTURK,112a14c770ec5b7f907fd95b5c13c,30P8I9JKOJ9NG8SSRNYUX8JRM685VL,0.1,501.0,MLDataLabeler,600,64,37,40,7,24,30,0.10616666666666667,1
MTURK,112a14c770ec5b7f907fd95b5c13c,30Z7M1Q8UZ8MB28WEQE1D5F53M88AP,0.1,442.0,MLDataLabeler,600,82,43,52,12,30,31,0.10716666666666667,1
MTURK,112a14c770ec5b7f907fd95b5c13c,3IV1AEQ4DS1XCVB08WRE64IOT928J5,0.1,442.0,MLDataLabeler,600,64,34,42,10,22,24,0.10566666666666667,1
MTURK,112a14c770ec5b7f907fd95b5c13c,3I6NF2WGIHK4YB2X2SZ8X7GHZRKG57,0.1,371.0,MLDataLabeler,600,63,34,38,3,25,31,0.10566666666666667,1
MTURK,112a14c770ec5b7f907fd95b5c13c,374UMBUHN6DT21XI12LNAW1GH2ECTK,0.1,371.0,MLDataLabeler,600,78,47,45,9,33,38,0.10783333333333334,1
MTURK,112a14c770ec5b7f907fd95b5c13c,3A520CCNWOO3K3INRT015FBREP6AEQ,0.1,366.0,MLDataLabeler,600,85,32,56,5,29,27,0.10533333333333333,1
MTURK,112a14c770ec5b7f907fd95b5c13c,3WA2XVDZEN52X16K1GJPPA95I6GE64,0.1,366.0,MLDataLabeler,600,101,42,64,5,37,37,0.10700000000000001,1
MTURK,112a14c770ec5b7f907fd95b5c13c,30U1YOGZGBK2STQHCYB8KXNC0JCDSW,0.1,327.0,MLDataLabeler,600,65,44,42,9,23,35,0.10733333333333334,1
MTURK,112a14c770ec5b7f907fd95b5c13c,35YHTYFL1HRFI5LHXZB3JKA4B0MVFU,0.1,327.0,MLDataLabeler,600,48,32,32,9,16,23,0.10533333333333333,1
MTURK,112a14c770ec5b7f907fd95b5c13c,3U74KRR67N9CT5U9QSU1Q7VSG6SNTD,0.1,262.0,MLDataLabeler,600,81,52,50,18,31,34,0.10866666666666668,1
MTURK,112a14c770ec5b7f907fd95b5c13c,3OLZC0DJ8K3ZSWN7Y7HOMHNWRSEVIL,0.1,262.0,MLDataLabeler,600,64,37,40,17,24,20,0.10616666666666667,1
MTURK,112a14c770ec5b7f907fd95b5c13c,3HKIF5DF6ZLNZY495ICP9NLJLN3G9Y,0.1,147.0,MLDataLabeler,600,82,46,52,19,30,27,0.10766666666666667,1
MTURK,112a14c770ec5b7f907fd95b5c13c,3VDI8GSXAGHNLTLZ0Q6B9RQ81HLG89,0.1,147.0,MLDataLabeler,600,63,36,42,15,21,21,0.10600000000000001,1
MTURK,112a14c770ec5b7f907fd95b5c13c,3CESM1J3EJRWE1SBMGDVBGG5PAF6W6,0.03,9.0,MLDataLabeler,300,65,120,36,29,29,91,0.041999999999999996,0
MTURK,112a14c770ec5b7f907fd95b5c13c,3H5TOKO3DA7K5Z9RCA7CGOXE5HG46I,0.03,10.0,MLDataLabeler,300,142,210,68,40,74,170,0.051,0
MTURK,112a14c770ec5b7f907fd95b5c13c,334ZEL5JX73TWQH627POVRZB4XCOSX,0.03,10.0,MLDataLabeler,300,204,270,99,44,105,226,0.056999999999999995,0
MTURK,112a14c770ec5b7f907fd95b5c13c,3X55NP42EP47X98SRS12CJWPMMA3P2,0.03,9.0,MLDataLabeler,300,108,180,53,38,55,142,0.048,0
MTURK,112a14c770ec5b7f907fd95b5c13c,388CL5C1RKBW0W0TELXXZWOF0HQLHS,0.03,10.0,MLDataLabeler,300,201,270,96,44,105,226,0.056999999999999995,0
MTURK,112a14c770ec5b7f907fd95b5c13c,33NOQL7T9PNNCAG4QIU0UY6EC798ZK,0.03,10.0,MLDataLabeler,300,202,270,97,44,105,226,0.056999999999999995,0
MTURK,112a14c770ec5b7f907fd95b5c13c,32CXT5U14HR6QBMUKVVSD6RZAPTU8G,0.03,10.0,MLDataLabeler,300,202,270,97,44,105,226,0.056999999999999995,0
MTURK,112a14c770ec5b7f907fd95b5c13c,3BFNCI9LYLEIR34SV67LCX54MS437V,0.03,10.0,MLDataLabeler,300,202,270,97,44,105,226,0.056999999999999995,0
MTURK,112a14c770ec5b7f907fd95b5c13c,3I6NF2WGIHK4YB2X2SZ8X7GHZRDG50,0.03,10.0,MLDataLabeler,300,202,270,97,44,105,226,0.056999999999999995,0
MTURK,112a14c770ec5b7f907fd95b5c13c,3E24UO25Q0EO9SJ9VUMLUM3JM8G6OU,0.03,9.0,MLDataLabeler,300,209,300,99,44,110,256,0.06,0
MTURK,112a14c770ec5b7f907fd95b5c13c,3X2LT8FDHX6JIFBZFVATVUCWV54W8H,0.03,9.0,MLDataLabeler,300,209,300,99,44,110,256,0.06,0
MTURK,112a14c770ec5b7f907fd95b5c13c,3EQPA8A3752C6JLVVQHA4WYIPPZJZ1,0.1,398.0,MC Lab,600,24,65,20,60,4,5,0.11083333333333334,0
MTURK,112a14c770ec5b7f907fd95b5c13c,3OLZC0DJ8JMR9A5SKWW5RLHG7OTVIU,0.5,0.0,Tuck Behavioral Research Lab,10800,40,257,11,35,29,222,0.5118981481481482,1
MTURK,112a14c770ec5b7f907fd95b5c13c,3LN3BXKGD3FAA07L75EXNA7105XGWT,0.01,36201.0,MTurk IRB Requester,180,50,182,37,41,13,141,0.020111111111111114,1
MTURK,112a14c770ec5b7f907fd95b5c13c,3PCPFX4U53AZC3F4KC99D0P3BPGQF0,0.01,36192.0,MTurk IRB Requester,180,49,68,49,60,0,8,0.013777777777777778,1
MTURK,112a14c770ec5b7f907fd95b5c13c,371QPA24D58LE4DOUHOJT3WWUMWT1G,0.01,36189.0,MTurk IRB Requester,180,40,57,39,44,1,13,0.013166666666666667,1
MTURK,112a14c770ec5b7f907fd95b5c13c,3WRKFXQBOCVGWQIC3I48TGRQ99HYIY,0.1,737.0,MLDataLabeler,600,41,35,21,3,20,32,0.10583333333333333,1
MTURK,112a14c770ec5b7f907fd95b5c13c,3D7VY91L66L6F1FSE5OGDY0659JMBN,0.1,737.0,MLDataLabeler,600,36,31,18,3,18,28,0.10516666666666667,1
MTURK,112a14c770ec5b7f907fd95b5c13c,3ACRLU860O283DNFX70X0QVXW7SEBQ,0.1,755.0,MLDataLabeler,600,55,42,28,6,27,36,0.10700000000000001,1
MTURK,112a14c770ec5b7f907fd95b5c13c,3KLL7H3EGEPZW1CNSPZ3M5MHRF0VHT,0.1,751.0,MLDataLabeler,600,80,62,47,12,33,50,0.11033333333333334,1
MTURK,112a14c770ec5b7f907fd95b5c13c,3H1C3QRA027RDIFLB7WSBA1FESSECX,0.1,752.0,MLDataLabeler,600,61,50,37,11,24,39,0.10833333333333334,1
MTURK,112a14c770ec5b7f907fd95b5c13c,34F34TZU7XNMQG9BSFIDWD5L79BJ2E,0.1,752.0,MLDataLabeler,600,48,36,31,8,17,28,0.10600000000000001,1
MTURK,112a14c770ec5b7f907fd95b5c13c,3B286OTISF5BVJ4F5UBS2VOJJX3JAL,0.1,744.0,MLDataLabeler,600,56,46,37,10,19,36,0.10766666666666667,1
MTURK,112a14c770ec5b7f907fd95b5c13c,3YO4AH2FPE8WGTAA8IY8AQOSO6JQ0S,0.1,744.0,MLDataLabeler,600,40,37,28,7,12,30,0.10616666666666667,1
MTURK,112a14c770ec5b7f907fd95b5c13c,39TX062QX2CC6IAJDJBJ6WISOLR3XY,0.1,732.0,MLDataLabeler,600,47,47,29,6,18,41,0.10783333333333334,1
MTURK,112a14c770ec5b7f907fd95b5c13c,336OE47KI38HTR7CNOL3N8W463DWVU,0.1,729.0,MLDataLabeler,600,61,58,38,20,23,38,0.10966666666666668,1
MTURK,112a14c770ec5b7f907fd95b5c13c,3OEWW2KGQKZNU1YO5HUZ0SDB3UAODB,0.1,729.0,MLDataLabeler,600,47,43,31,14,16,29,0.10716666666666667,1
MTURK,112a14c770ec5b7f907fd95b5c13c,32L724R85M8MNCQBCV8PGPYE54EIPO,0.1,721.0,MLDataLabeler,600,87,52,55,11,32,41,0.10866666666666668,1
MTURK,112a14c770ec5b7f907fd95b5c13c,3PA41K45VOSPYS9FT44SP085RO3P70,0.1,721.0,MLDataLabeler,600,69,37,44,3,25,34,0.10616666666666667,1
MTURK,112a14c770ec5b7f907fd95b5c13c,3KTZHH2ONJ3ND3HLBT46MWA5X3YM8O,0.1,721.0,MLDataLabeler,600,82,46,55,8,27,38,0.10766666666666667,1
MTURK,112a14c770ec5b7f907fd95b5c13c,3XWUWJ18TME4O8T7NYWX9Y9O7GTUU4,0.1,721.0,MLDataLabeler,600,65,34,45,7,20,27,0.10566666666666667,1
MTURK,112a14c770ec5b7f907fd95b5c13c,36U4VBVNQP1C8G1QJ41S4NM40HPRUX,0.1,726.0,MLDataLabeler,600,100,50,64,8,36,42,0.10833333333333334,1
MTURK,112a14c770ec5b7f907fd95b5c13c,3FO95NVK5DOWT39MUZ6SPM4GFK4SRI,0.1,726.0,MLDataLabeler,600,82,33,54,2,28,31,0.10550000000000001,1
MTURK,112a14c770ec5b7f907fd95b5c13c,3VMV5CHJZ936JDDN3OH60NMVFU7TGC,0.1,709.0,MLDataLabeler,600,72,39,46,11,26,28,0.10650000000000001,1
MTURK,112a14c770ec5b7f907fd95b5c13c,3D42WVSDH9JWMZGM2AYNQJEYTHPYF7,0.1,709.0,MLDataLabeler,600,56,31,36,10,20,21,0.10516666666666667,1
MTURK,112a14c770ec5b7f907fd95b5c13c,3KL228NDMWA7GUN09F3EZWZZWHGGKT,0.1,686.0,MLDataLabeler,600,82,46,54,8,28,38,0.10766666666666667,1
MTURK,112a14c770ec5b7f907fd95b5c13c,3DWGDA5POGSOSQR9Q0WIUI6AAQ4V1U,0.1,686.0,MLDataLabeler,600,65,39,44,7,21,32,0.10650000000000001,1
MTURK,112a14c770ec5b7f907fd95b5c13c,37AQKJ12TYCAOIZTNOGDZ61K5OFTTL,0.1,688.0,MLDataLabeler,600,85,50,55,14,30,36,0.10833333333333334,1
MTURK,112a14c770ec5b7f907fd95b5c13c,31KSVEGZ35GP0KQVE4GTMB71LX0RWW,0.1,688.0,MLDataLabeler,600,68,40,45,14,23,26,0.10666666666666667,1
MTURK,112a14c770ec5b7f907fd95b5c13c,3RTFSSG7T9UEXMVI9KJX0ZY2F5BLW0,0.1,657.0,MLDataLabeler,600,86,44,56,8,30,36,0.10733333333333334,1
MTURK,112a14c770ec5b7f907fd95b5c13c,3Y7LTZE0YUALA7NHTLV5QQO39Y8UZT,0.1,657.0,MLDataLabeler,600,69,32,44,5,25,27,0.10533333333333333,1
MTURK,112a14c770ec5b7f907fd95b5c13c,3KTCJ4SCVHP523X0C8VR7MNXJXT1MK,0.1,681.0,MLDataLabeler,600,64,42,43,14,21,28,0.10700000000000001,1
MTURK,112a14c770ec5b7f907fd95b5c13c,3G9UA71JVWITCH6HYRZ8S4MTIPXJ7U,0.1,681.0,MLDataLabeler,600,48,34,33,13,15,21,0.10566666666666667,1
MTURK,112a14c770ec5b7f907fd95b5c13c,3EHVO81VN69JAPWPLBFEFHF12BU1HB,0.1,632.0,MLDataLabeler,600,45,32,31,5,14,27,0.10533333333333333,1
MTURK,112a14c770ec5b7f907fd95b5c13c,39WICJI5AUG1BDAYE1Z43HY3WLOZ3Q,0.1,632.0,MLDataLabeler,600,64,44,43,10,21,34,0.10733333333333334,1
MTURK,112a14c770ec5b7f907fd95b5c13c,31MCUE39BLA1KWFTO9BFIAIXLVUG3I,0.1,564.0,MLDataLabeler,600,79,40,54,12,25,28,0.10666666666666667,1
MTURK,112a14c770ec5b7f907fd95b5c13c,33KGGVH24V5GWFW4QFX0I33VQ1D1X4,0.1,564.0,MLDataLabeler,600,61,30,44,9,17,21,0.10500000000000001,1
MTURK,112a14c770ec5b7f907fd95b5c13c,3BPP3MA3TD8KGM9ROKPRETR2816LEK,0.1,602.0,MLDataLabeler,600,92,54,62,14,30,40,0.10900000000000001,1
MTURK,112a14c770ec5b7f907fd95b5c13c,3WYZV0QBFK1H9DEWSCQPOFG4CD3XBI,0.1,602.0,MLDataLabeler,600,73,43,49,9,24,34,0.10716666666666667,1
MTURK,112a14c770ec5b7f907fd95b5c13c,3O71U79SRCD5WNWUPRAB3NA69X5MSO,0.1,525.0,MLDataLabeler,600,103,48,66,9,37,39,0.10800000000000001,1
MTURK,112a14c770ec5b7f907fd95b5c13c,3E6L1VR4XXAU3F6GWR3V7SU5U7W6FF,0.1,525.0,MLDataLabeler,600,85,35,56,7,29,28,0.10583333333333333,1
MTURK,112a14c770ec5b7f907fd95b5c13c,3YOAVL4CA15MT9T2EF4NDMQ9ALKZ4B,0.1,472.0,MLDataLabeler,600,69,39,44,8,25,31,0.10650000000000001,1
MTURK,112a14c770ec5b7f907fd95b5c13c,3S8APUMBJY709RNBSIK3I8GX888FBA,0.1,472.0,MLDataLabeler,600,53,32,34,7,19,25,0.10533333333333333,1
MTURK,112a14c770ec5b7f907fd95b5c13c,39N6W9XWREB20ZCHDU4584EAUWPGYO,0.1,490.0,MLDataLabeler,600,107,52,70,9,37,43,0.10866666666666668,1
MTURK,112a14c770ec5b7f907fd95b5c13c,3CMIQF80GOERU4WPA7EPJRYJ1966QA,0.1,490.0,MLDataLabeler,600,88,32,58,5,30,27,0.10533333333333333,1
MTURK,112a14c770ec5b7f907fd95b5c13c,3538U0YQ1GIV6WJYDP5X0PILKGVF3J,0.1,397.0,MLDataLabeler,600,114,61,72,11,42,50,0.11016666666666668,0
MTURK,112a14c770ec5b7f907fd95b5c13c,3SR6AEG6W6HG0V7SX0MNT4QB9W3HYP,0.1,415.0,MLDataLabeler,600,70,40,45,3,25,37,0.10666666666666667,0
MTURK,112a14c770ec5b7f907fd95b5c13c,3D0LPO3EACNQSCTF1DHDDDNCLIGOYJ,0.1,397.0,MLDataLabeler,600,90,53,55,10,35,43,0.10883333333333334,0
MTURK,112a14c770ec5b7f907fd95b5c13c,3G57RS03HITEJHUQ3DEJV3MGP8H52F,0.1,339.0,MLDataLabeler,600,84,39,54,8,30,31,0.10650000000000001,0
MTURK,112a14c770ec5b7f907fd95b5c13c,30OITAWPBRR1ZUZKPOU7UNXK0NI9HS,0.1,339.0,MLDataLabeler,600,66,33,43,6,23,27,0.10550000000000001,0
MTURK,112a14c770ec5b7f907fd95b5c13c,3D3B8GE893FTCBX8812C3WZBMES9PX,0.1,339.0,MLDataLabeler,600,78,44,49,8,29,36,0.10733333333333334,1
MTURK,112a14c770ec5b7f907fd95b5c13c,3ZRKL6Z1E9R54D08EOCGQIQ9DBTSGM,0.1,339.0,MLDataLabeler,600,62,29,40,6,22,23,0.10483333333333333,1
MTURK,112a14c770ec5b7f907fd95b5c13c,34F34TZU7XNMQG9BSFIDWD5L79C2JY,0.1,267.0,MLDataLabeler,600,78,40,51,8,27,32,0.10666666666666667,1
MTURK,112a14c770ec5b7f907fd95b5c13c,334ZEL5JX73TWQH627POVRZB4XKSO9,0.1,267.0,MLDataLabeler,600,63,31,43,6,20,25,0.10516666666666667,1
MTURK,112a14c770ec5b7f907fd95b5c13c,3YLTXLH3DGUMRHFR6DQ4GDXZ5R0HPV,0.1,201.0,MLDataLabeler,600,79,38,53,8,26,30,0.10633333333333334,1
MTURK,112a14c770ec5b7f907fd95b5c13c,3JYPJ2TAYJW2DLOLBN24DSLMPCNFPV,0.1,201.0,MLDataLabeler,600,65,29,44,5,21,24,0.10483333333333333,1
MTURK,112a14c770ec5b7f907fd95b5c13c,3Z33IC0JC1A6HVU4UDBB9OOT82T9VI,0.1,23.0,MLDataLabeler,600,39,35,22,6,17,29,0.10583333333333333,1
MTURK,112a14c770ec5b7f907fd95b5c13c,3S4TINXCC0NZOA7TTWDH5QC4I6ROBU,0.07,90.0,Matthew Shardlow,3600,36,163,28,156,8,7,0.07316944444444445,0
MTURK,112a14c770ec5b7f907fd95b5c13c,3TTPFEFXDX60ZR1YLROW1EHCS0J6HL,10.0,1.0,R4P,7200,30,42,21,31,9,11,10.058333333333334,0
MTURK,112a14c770ec5b7f907fd95b5c13c,3R16PJFTS4VWGLWGJPCH0TNWUWC4KM,1.0,0.0,Tom Allison,14400,84,362,45,52,39,310,1.0251388888888888,0
MTURK,112a14c770ec5b7f907fd95b5c13c,31MCUE39BKU18U72EMST85J2PGI3GV,0.15,3708.0,Anita,3600,180,2030,169,1967,11,63,0.2345833333333333,1
MTURK,112a14c770ec5b7f907fd95b5c13c,3RWO3EJELHHBB4MMU14XELIXSNR1P5,0.15,3711.0,Anita,3600,71,1772,69,1755,2,17,0.22383333333333333,1
MTURK,112a14c770ec5b7f907fd95b5c13c,3S8APUMBJXR0XPFKIV1H83H2CTVBFV,0.15,3706.0,Anita,3600,205,311,188,236,17,75,0.16295833333333332,1
MTURK,112a14c770ec5b7f907fd95b5c13c,37VHPF5VYCBASFX3OHR69V6Y7AIC8M,0.15,3708.0,Anita,3600,34,73,34,64,0,9,0.15304166666666666,1
MTURK,112a14c770ec5b7f907fd95b5c13c,36AZSFEYZ48PTM1AIA6LQPKO0NJBVJ,0.15,3708.0,Anita,3600,43,80,43,41,0,39,0.15333333333333332,1
MTURK,112a14c770ec5b7f907fd95b5c13c,33QQ60S6ASQOWK90F4ZRAMMMVCCU0Q,0.15,3704.0,Anita,3600,99,244,91,214,8,30,0.16016666666666665,1
MTURK,112a14c770ec5b7f907fd95b5c13c,3HJ1EVZS2ORSXKGGUXM579X9RPSR3E,0.15,3703.0,Anita,3600,169,565,148,474,21,91,0.17354166666666665,1
MTURK,112a14c770ec5b7f907fd95b5c13c,304QEQWKZPSTJFP3JINIBGUXDQP0OK,0.15,3703.0,Anita,3600,323,831,291,656,32,175,0.18462499999999998,1
MTURK,112a14c770ec5b7f907fd95b5c13c,3R16PJFTS3ZRSCMP4RIRG231AXV4KK,0.15,3704.0,Anita,3600,151,211,121,162,30,49,0.15879166666666666,0
MTURK,112a14c770ec5b7f907fd95b5c13c,3BAKUKE49HKWNH217T8MJGICT5ER1M,0.15,3702.0,Anita,3600,29,62,29,47,0,15,0.15258333333333332,1
MTURK,112a14c770ec5b7f907fd95b5c13c,3N7PQ0KLI5X3OGBB8R2582YQC03E3P,0.15,3705.0,Anita,3600,28,78,28,67,0,11,0.15325,1
MTURK,112a14c770ec5b7f907fd95b5c13c,3XBYQ44Z6PC24XVW8622CL9OD3KTW0,0.15,3705.0,Anita,3600,72,107,38,61,34,46,0.15445833333333334,1
MTURK,112a14c770ec5b7f907fd95b5c13c,3NSM4HLQNR2KSK7IFT91FRGF5V4QQF,0.15,3703.0,Anita,3600,57,211,50,137,7,74,0.15879166666666666,1
MTURK,112a14c770ec5b7f907fd95b5c13c,3D17ECOUOE344FHZW37Q1IFWNRZ13T,0.15,3703.0,Anita,3600,22,54,22,48,0,6,0.15225,1
MTURK,112a14c770ec5b7f907fd95b5c13c,3M7OI89LVYWNO1EFV2U8PHA71FSC60,0.15,3705.0,Anita,3600,29,47,29,37,0,10,0.15195833333333333,1
MTURK,112a14c770ec5b7f907fd95b5c13c,3OB6JN3A9QXTJ6OQ0FRK386FRG9RMU,0.15,3706.0,Anita,3600,29,47,29,41,0,6,0.15195833333333333,1
MTURK,112a14c770ec5b7f907fd95b5c13c,3KI0JD2ZU1QHCKJJ4LMX9VIT041671,0.15,3706.0,Anita,3600,26,54,26,46,0,8,0.15225,1
MTURK,112a14c770ec5b7f907fd95b5c13c,3LB1BGHFL246T2QWN7KQXIU4OBKYT4,0.15,3705.0,Anita,3600,81,237,75,192,6,45,0.159875,1
MTURK,112a14c770ec5b7f907fd95b5c13c,3YOAVL4CA0PMH7LB4SL13HREE67Z40,0.15,3688.0,Anita,3600,99,183,72,85,27,98,0.157625,1
MTURK,112a14c770ec5b7f907fd95b5c13c,3XQ4XW3OD9KFDHKA5M85E9XD7DDS2U,0.15,1741.0,Anita,3600,52,90,51,61,1,29,0.15375,1
MTURK,112a14c770ec5b7f907fd95b5c13c,39O0SQZVJNFAY3H3W9PVKQ9PWRG7R1,0.15,1736.0,Anita,3600,75,112,75,79,0,33,0.15466666666666667,1
MTURK,112a14c770ec5b7f907fd95b5c13c,3UEBBGULPFWFTOOQIMICDT9Q1E2UFV,0.15,1733.0,Anita,3600,103,155,101,115,2,40,0.15645833333333334,1
MTURK,112a14c770ec5b7f907fd95b5c13c,3RIHDBQ1NE6GUCAN4AFQP44947DMHU,0.15,1735.0,Anita,3600,29,43,29,35,0,8,0.15179166666666666,1
MTURK,112a14c770ec5b7f907fd95b5c13c,3MIVREZQVH6YHH9N2OP4J5466PEKQJ,0.15,1735.0,Anita,3600,68,78,66,59,2,19,0.15325,1
MTURK,112a14c770ec5b7f907fd95b5c13c,3ECKRY5B1Q4GPEKQPHN5XI1XJOAIZ0,0.15,1733.0,Anita,3600,65,66,65,52,0,14,0.15275,1
MTURK,112a14c770ec5b7f907fd95b5c13c,34HEO7RUG62SH5F13C1FUHBFXZMARV,0.15,1733.0,Anita,3600,44,43,44,36,0,7,0.15179166666666666,1
MTURK,112a14c770ec5b7f907fd95b5c13c,324N5FAHSXJQMP54ONJEPS3ENHTKVD,0.15,1727.0,Anita,3600,64,52,64,39,0,13,0.15216666666666667,1
MTURK,112a14c770ec5b7f907fd95b5c13c,3BAWBGQGYL72RAYK5TU5LNYSHXTV7I,0.15,1727.0,Anita,3600,47,33,47,23,0,10,0.15137499999999998,1
MTURK,112a14c770ec5b7f907fd95b5c13c,37J05LC5AXR9HOZ0FHJ8IRXU8LPDJ8,0.15,1727.0,Anita,3600,62,49,62,33,0,16,0.15204166666666666,1
MTURK,112a14c770ec5b7f907fd95b5c13c,3QREJ3J4335NQKTAAJH82J5CWJRKLU,0.15,1727.0,Anita,3600,45,30,45,18,0,12,0.15125,1
MTURK,112a14c770ec5b7f907fd95b5c13c,3P6ENY9P794UYTKWJVHYXBXSNYTHI9,0.15,1723.0,Anita,3600,46,46,46,33,0,13,0.15191666666666667,1
MTURK,112a14c770ec5b7f907fd95b5c13c,3U74KRR67MTCH3MIG5BFG2WXKRINT5,0.15,1723.0,Anita,3600,47,62,47,45,0,17,0.15258333333333332,1
MTURK,112a14c770ec5b7f907fd95b5c13c,3KI0JD2ZU1QHCKJJ4LMX9VIT042763,0.15,1719.0,Anita,3600,46,68,46,49,0,19,0.15283333333333332,1
MTURK,112a14c770ec5b7f907fd95b5c13c,31GN6YMHLP01PXIHJ6XC2GD2BK8SWC,0.15,1718.0,Anita,3600,52,74,52,53,0,21,0.15308333333333332,1
MTURK,112a14c770ec5b7f907fd95b5c13c,32TMVRKDGN67XBKOV2LOQXUAFX2846,0.15,1717.0,Anita,3600,72,76,72,55,0,21,0.15316666666666667,1
MTURK,112a14c770ec5b7f907fd95b5c13c,30UZJB2POHK3SXIIXQ9248SDZ7635F,0.15,1717.0,Anita,3600,53,48,53,37,0,11,0.152,1
MTURK,112a14c770ec5b7f907fd95b5c13c,30U1YOGZGA42GRIQ2BSMASOH442DSO,0.15,1640.0,Anita,3600,57,3265,57,3249,0,16,0.28604166666666664,1
MTURK,112a14c770ec5b7f907fd95b5c13c,360ZO6N6J1RNF6S46YRYCN6LLU59MR,0.15,1640.0,Anita,3600,58,3303,58,3286,0,17,0.287625,1
MTURK,112a14c770ec5b7f907fd95b5c13c,36BTXXLZ2VGDFGZKUBROHEPF5PQR41,0.15,1639.0,Anita,3600,41,88,41,77,0,11,0.15366666666666667,1
MTURK,112a14c770ec5b7f907fd95b5c13c,32PT7WK7DMNYWAXBCWRL2KG5CO43DN,0.15,1639.0,Anita,3600,49,74,49,60,0,14,0.15308333333333332,1
MTURK,112a14c770ec5b7f907fd95b5c13c,3LN3BXKGC03YZS9QO63VD2UZN9EGWG,0.15,1638.0,Anita,3600,69,102,69,70,0,32,0.15425,1
MTURK,112a14c770ec5b7f907fd95b5c13c,3FHTJGYT8N88FJCPCKP0L8M3UCBGPL,0.15,1638.0,Anita,3600,55,81,55,54,0,27,0.15337499999999998,1
MTURK,112a14c770ec5b7f907fd95b5c13c,3GKAWYFRAP153Z2YAUOSFNJ6HKVDP8,0.15,1638.0,Anita,3600,51,53,51,33,0,20,0.15220833333333333,1
MTURK,112a14c770ec5b7f907fd95b5c13c,3N7PQ0KLI5X3OGBB8R2582YQC04E3Q,0.15,1636.0,Anita,3600,51,64,51,42,0,22,0.15266666666666667,1
MTURK,112a14c770ec5b7f907fd95b5c13c,3WGCNLZJKFG2M7JWPSD2ER18E4PD14,0.15,1634.0,Anita,3600,68,94,68,78,0,16,0.15391666666666667,1
MTURK,112a14c770ec5b7f907fd95b5c13c,3UXQ63NLAAUMXHPG464F3GMM9PILBB,0.15,1634.0,Anita,3600,49,79,49,68,0,11,0.15329166666666666,1
MTURK,112a14c770ec5b7f907fd95b5c13c,344M16OZKINASK4LQAMKHGWWHHVNEF,0.15,1632.0,Anita,3600,64,87,64,76,0,11,0.15362499999999998,1
MTURK,112a14c770ec5b7f907fd95b5c13c,322ZSN9Z5GSQVVCCY0WJHTQXTAN4TR,0.15,1632.0,Anita,3600,47,74,47,67,0,7,0.15308333333333332,1
MTURK,112a14c770ec5b7f907fd95b5c13c,3OQQD2WO8IEF4LDX4ASWTHWI4TC3IP,0.15,1631.0,Anita,3600,76,124,76,93,0,31,0.15516666666666667,1
MTURK,112a14c770ec5b7f907fd95b5c13c,34F34TZU7W7MEE1KISZRM86QBU0J25,0.15,1632.0,Anita,3600,45,56,45,49,0,7,0.15233333333333332,1
MTURK,112a14c770ec5b7f907fd95b5c13c,3QHITW7OYOHS5401QXCFPR1A1DKQAA,0.15,1631.0,Anita,3600,55,109,55,82,0,27,0.15454166666666666,1
MTURK,112a14c770ec5b7f907fd95b5c13c,39O6Z4JLX25W6P4BN6Y3FMBGJQ8XVF,0.15,1630.0,Anita,3600,50,58,50,38,0,20,0.15241666666666667,1
MTURK,112a14c770ec5b7f907fd95b5c13c,3DTJ4WT8BDN499I4TYXEC335RV3EZN,0.15,1630.0,Anita,3600,86,101,86,57,0,44,0.15420833333333334,1
MTURK,112a14c770ec5b7f907fd95b5c13c,31ODACBENUNW50MV7XY6ARVGNJRQS6,0.15,1629.0,Anita,3600,93,93,93,57,0,36,0.15387499999999998,1
MTURK,112a14c770ec5b7f907fd95b5c13c,3ZFRE2BDQ9MDF99LO3N60SOC71EXZF,0.15,1629.0,Anita,3600,50,38,50,26,0,12,0.15158333333333332,1
MTURK,112a14c770ec5b7f907fd95b5c13c,3L7SUC0TTU25JC4R6285JC5SIQBM0S,0.15,1628.0,Anita,3600,62,58,62,36,0,22,0.15241666666666667,1
MTURK,112a14c770ec5b7f907fd95b5c13c,3AFT28WXLFA4QA6JN8COHKUTZK7OI4,0.15,1628.0,Anita,3600,45,42,45,24,0,18,0.15175,1
MTURK,112a14c770ec5b7f907fd95b5c13c,3MGHRFQY2LX5DTT5P5WGD7SZR0PY0U,0.15,1626.0,Anita,3600,72,91,72,74,0,17,0.15379166666666666,1
MTURK,112a14c770ec5b7f907fd95b5c13c,3G9UA71JVV2T0FYQO4GMIZNYMAMJ7L,0.15,1626.0,Anita,3600,46,76,46,65,0,11,0.15316666666666667,1
MTURK,112a14c770ec5b7f907fd95b5c13c,3B9J25CZ25LSBZCC2FXBQM6ZJ4QCSN,0.15,1626.0,Anita,3600,49,46,49,36,0,10,0.15191666666666667,1
MTURK,112a14c770ec5b7f907fd95b5c13c,362E9TQF2HYGYXPLZPZGCBLR8YGIGB,0.15,1625.0,Anita,3600,49,53,49,41,0,12,0.15220833333333333,1
MTURK,112a14c770ec5b7f907fd95b5c13c,3KQC8JMJGC0F8Q2DYSABT5V34GX3HW,0.15,1625.0,Anita,3600,51,70,49,53,2,17,0.15291666666666667,1
MTURK,112a14c770ec5b7f907fd95b5c13c,3P888QFVX32H78U20GHXQMLFQUOQO9,0.15,1616.0,Anita,3600,66,531,56,115,10,416,0.172125,1
MTURK,112a14c770ec5b7f907fd95b5c13c,3B9J25CZ25LSBZCC2FXBQM6ZJ4QSC3,0.15,1616.0,Anita,3600,79,529,69,113,10,416,0.17204166666666665,1
MTURK,112a14c770ec5b7f907fd95b5c13c,3UQ1LLR26AGHE7KOYS4J852GR7XLAG,0.15,1616.0,Anita,3600,69,59,69,46,0,13,0.15245833333333333,1
MTURK,112a14c770ec5b7f907fd95b5c13c,3MWOYZD5WVWW4BHAKOPGMSQALJ1NOJ,0.15,1616.0,Anita,3600,45,42,45,34,0,8,0.15175,1
MTURK,112a14c770ec5b7f907fd95b5c13c,306W7JMRYY6RIA5XAHVBYB0GPPJB8F,0.15,1615.0,Anita,3600,48,87,48,51,0,36,0.15362499999999998,1
MTURK,112a14c770ec5b7f907fd95b5c13c,3B286OTISEPBJHWOV7S6SQPONISJAC,0.15,1614.0,Anita,3600,58,106,58,65,0,41,0.15441666666666667,1
MTURK,112a14c770ec5b7f907fd95b5c13c,306996CF6WS97ALCBWMWJ1D8BJDB1V,0.15,1613.0,Anita,3600,76,74,76,56,0,18,0.15308333333333332,1
MTURK,112a14c770ec5b7f907fd95b5c13c,3W3RSPVVGSZ1TGYM4XLA86EAYAOUL0,0.15,1613.0,Anita,3600,50,43,50,31,0,12,0.15179166666666666,1
MTURK,112a14c770ec5b7f907fd95b5c13c,35O6H0UNLSOEDBK70B1PKF92V4RJ56,0.15,1613.0,Anita,3600,47,36,47,27,0,9,0.1515,1
MTURK,112a14c770ec5b7f907fd95b5c13c,3K3G488TR2GVZYOKV1LYHGLO9ZJ5QJ,0.15,1613.0,Anita,3600,64,52,64,39,0,13,0.15216666666666667,1
MTURK,112a14c770ec5b7f907fd95b5c13c,3KTCJ4SCVG95Q1P92LC5XHO2NIHM1V,0.15,1610.0,Anita,3600,50,55,50,43,0,12,0.15229166666666666,1
MTURK,112a14c770ec5b7f907fd95b5c13c,37Y5RYYI0PDGEXN7TBTY4ZR9KMEXSA,0.15,1609.0,Anita,3600,68,74,68,60,0,14,0.15308333333333332,1
MTURK,112a14c770ec5b7f907fd95b5c13c,3T2EL38U0MS41H8U174T9ZC82YTQXE,0.15,1609.0,Anita,3600,47,43,47,36,0,7,0.15179166666666666,1
MTURK,112a14c770ec5b7f907fd95b5c13c,36818Z1KV3L0Y3UZSM0JCJ8ZRL73AL,0.15,1609.0,Anita,3600,50,55,50,40,0,15,0.15229166666666666,1
MTURK,112a14c770ec5b7f907fd95b5c13c,3LG268AV38EV7IWDJH31Q016IEKRE7,0.15,1608.0,Anita,3600,71,60,71,37,0,23,0.1525,1
MTURK,112a14c770ec5b7f907fd95b5c13c,3D1TUISJWI8Z3FQGJUOXGQMIH6VIUB,0.15,1608.0,Anita,3600,50,43,50,31,0,12,0.15179166666666666,1
MTURK,112a14c770ec5b7f907fd95b5c13c,30Y6N4AHYP4QFCIDNMSHKIJLI2JDR0,0.15,1608.0,Anita,3600,57,41,57,31,0,10,0.15170833333333333,1
MTURK,112a14c770ec5b7f907fd95b5c13c,3W3RSPVVGSZ1TGYM4XLA86EAYAPLUS,0.15,1608.0,Anita,3600,74,53,74,39,0,14,0.15220833333333333,1
MTURK,112a14c770ec5b7f907fd95b5c13c,372AGES0I4D4DINUEMTTEPMDYKVXRM,0.15,1607.0,Anita,3600,64,55,64,38,0,17,0.15229166666666666,1
MTURK,112a14c770ec5b7f907fd95b5c13c,3MNJFORX8BCY89YBHLA45HHA2XA5FP,0.15,1606.0,Anita,3600,62,62,62,27,0,35,0.15258333333333332,1
MTURK,112a14c770ec5b7f907fd95b5c13c,3IVKZBIBJ0HJS7NSO7BC1D3FWWVSHC,0.15,1606.0,Anita,3600,65,76,65,44,0,32,0.15316666666666667,1
MTURK,112a14c770ec5b7f907fd95b5c13c,3DW3BNF1GHQ6RO33FYMBZNUNSHZV85,0.15,1606.0,Anita,3600,44,38,44,28,0,10,0.15158333333333332,1
MTURK,112a14c770ec5b7f907fd95b5c13c,3DZKABX2ZID83RTGWA2G19Q6I8KVCB,0.15,1603.0,Anita,3600,67,58,67,41,0,17,0.15241666666666667,1
MTURK,112a14c770ec5b7f907fd95b5c13c,3XT3KXP24Z6E140FNCQU0K82EKD6IX,0.15,1603.0,Anita,3600,52,40,52,27,0,13,0.15166666666666667,1
MTURK,112a14c770ec5b7f907fd95b5c13c,3JMQI2OLFZD50EQLUFB0BYEBH5UNDM,0.15,1603.0,Anita,3600,65,36,65,25,0,11,0.1515,1
MTURK,112a14c770ec5b7f907fd95b5c13c,3MNJFORX8BCY89YBHLA45HHA2XAF5Z,0.15,1603.0,Anita,3600,81,48,81,33,0,15,0.152,1
MTURK,112a14c770ec5b7f907fd95b5c13c,3HEM8MA6H9KZS863FGUCFMQ50ZKQPQ,0.15,1602.0,Anita,3600,48,44,48,33,0,11,0.15183333333333332,1
MTURK,112a14c770ec5b7f907fd95b5c13c,3BDORL6HKKLGAKCZNQX60C13X27CRZ,0.15,1600.0,Anita,3600,51,64,51,52,0,12,0.15266666666666667,1
MTURK,112a14c770ec5b7f907fd95b5c13c,3511RHPADVM9DO6503Q53VRQRBLLRO,0.15,1601.0,Anita,3600,43,74,43,60,0,14,0.15308333333333332,1
MTURK,112a14c770ec5b7f907fd95b5c13c,33CLA8O0MIJNDWW9ESN78IM6UFZRFP,0.15,1600.0,Anita,3600,59,80,59,58,0,22,0.15333333333333332,1
MTURK,112a14c770ec5b7f907fd95b5c13c,3DWNFENNE33WHSG7M6IFFN3OV8WJ41,0.15,1600.0,Anita,3600,40,34,40,23,0,11,0.15141666666666667,1
MTURK,112a14c770ec5b7f907fd95b5c13c,3JTPR5MTZSK9OVQPIW11LU9FATR5KR,0.15,1600.0,Anita,3600,42,42,42,32,0,10,0.15175,1
MTURK,112a14c770ec5b7f907fd95b5c13c,3TL87MO8CMXCAY1W98QBM6D7ONAFLN,0.15,1598.0,Anita,3600,47,107,47,62,0,45,0.15445833333333334,1
MTURK,112a14c770ec5b7f907fd95b5c13c,3N7PQ0KLI5X3OGBB8R2582YQC053EG,0.15,1600.0,Anita,3600,43,59,43,40,0,19,0.15245833333333333,1
MTURK,112a14c770ec5b7f907fd95b5c13c,3BPP3MA3TCSK4K10EX654OS7CMVLEB,0.15,1596.0,Anita,3600,74,134,74,79,0,55,0.15558333333333332,1
MTURK,112a14c770ec5b7f907fd95b5c13c,3IVEC1GSLP7FPTJOZOZDHPWLJOMJ1O,0.15,1596.0,Anita,3600,55,86,55,62,0,24,0.15358333333333332,1
MTURK,112a14c770ec5b7f907fd95b5c13c,3LAZVA75NIZ0FPSHY5RWU4NCAOAO2T,0.15,1594.0,Anita,3600,47,74,47,51,0,23,0.15308333333333332,1
MTURK,112a14c770ec5b7f907fd95b5c13c,3OID399FXGFTCMD4WRSN3T52FE8DF5,0.15,1596.0,Anita,3600,49,57,49,36,0,21,0.15237499999999998,1
MTURK,112a14c770ec5b7f907fd95b5c13c,37J05LC5AXR9HOZ0FHJ8IRXU8LPJDE,0.15,1592.0,Anita,3600,71,92,71,48,0,44,0.15383333333333332,1
MTURK,112a14c770ec5b7f907fd95b5c13c,34KYK9TV2RG91UK6OF1GF20H1JQSBW,0.15,1592.0,Anita,3600,52,72,52,36,0,36,0.153,1
MTURK,112a14c770ec5b7f907fd95b5c13c,3AQN9REUTFOZCDUZ1HKBSECILPYDY2,0.15,1592.0,Anita,3600,51,101,51,59,0,42,0.15420833333333334,1
MTURK,112a14c770ec5b7f907fd95b5c13c,30U1YOGZGA42GRIQ2BSMASOH442SD3,0.15,1591.0,Anita,3600,51,52,51,39,0,13,0.15216666666666667,1
MTURK,112a14c770ec5b7f907fd95b5c13c,302U8RURJZ9RUVQ7L0BUHKKIHCYVNT,0.15,1592.0,Anita,3600,67,137,67,84,0,53,0.15570833333333334,1
MTURK,112a14c770ec5b7f907fd95b5c13c,3AQN9REUTFOZCDUZ1HKBSECILPYYDN,0.15,1592.0,Anita,3600,92,115,92,84,0,31,0.15479166666666666,1
MTURK,112a14c770ec5b7f907fd95b5c13c,3JYPJ2TAYIG21JGU10JI3NMRTXBFPL,0.15,1592.0,Anita,3600,56,40,56,26,0,14,0.15166666666666667,1
MTURK,112a14c770ec5b7f907fd95b5c13c,3HRWUH63QUAAW1BSF9THDMQJ4OW5NW,0.15,1591.0,Anita,3600,51,74,51,52,0,22,0.15308333333333332,1
MTURK,112a14c770ec5b7f907fd95b5c13c,3BAKUKE49HKWNH217T8MJGICT5GR1O,0.15,1591.0,Anita,3600,52,90,52,65,0,25,0.15375,1
MTURK,112a14c770ec5b7f907fd95b5c13c,3O71U79SRBX5KLO3F4RPTIBBDIUSML,0.15,1591.0,Anita,3600,58,118,58,81,0,37,0.15491666666666665,1
MTURK,112a14c770ec5b7f907fd95b5c13c,3BFF0DJK8XK9XGENO1S1FW637QQSTM,0.15,1591.0,Anita,3600,86,109,86,65,0,44,0.15454166666666666,1
MTURK,112a14c770ec5b7f907fd95b5c13c,3X55NP42EOO7L701H5IG2EXUQ773P1,0.15,1591.0,Anita,3600,54,40,54,28,0,12,0.15166666666666667,1
MTURK,112a14c770ec5b7f907fd95b5c13c,3J9UN9O9J30FI4Y635VD3KDBEWH0J3,0.15,1591.0,Anita,3600,51,47,51,29,0,18,0.15195833333333333,1
MTURK,112a14c770ec5b7f907fd95b5c13c,3MQY1YVHS3SGWV38U0MAOKND3PRB2C,0.15,1589.0,Anita,3600,58,62,58,42,0,20,0.15258333333333332,1
MTURK,112a14c770ec5b7f907fd95b5c13c,32K26U12DNWI8JZUW6XRLF8O38WDVT,0.15,1588.0,Anita,3600,69,72,69,60,0,12,0.153,1
MTURK,112a14c770ec5b7f907fd95b5c13c,38RHULDV9YNCVJFLEU3YYE7F2M6IWA,0.15,1588.0,Anita,3600,45,39,45,32,0,7,0.15162499999999998,1
MTURK,112a14c770ec5b7f907fd95b5c13c,38G0E1M85MD4PLAGI1NGVFCCP8RUVK,0.15,1587.0,Anita,3600,50,51,50,37,0,14,0.15212499999999998,1
MTURK,112a14c770ec5b7f907fd95b5c13c,3E9VAUV7BWM1E6RNH7T92D4C0M1YAL,0.15,1587.0,Anita,3600,52,64,52,46,0,18,0.15266666666666667,1
MTURK,112a14c770ec5b7f907fd95b5c13c,3VEI3XUCZR5Z49L3SVJCKC0AWLMPRQ,0.15,1587.0,Anita,3600,65,79,65,58,0,21,0.15329166666666666,1
MTURK,112a14c770ec5b7f907fd95b5c13c,37MQ8Z1JQE4C93WJ4S0UWVLEOY9Y2E,0.15,1587.0,Anita,3600,46,50,46,37,0,13,0.15208333333333332,1
MTURK,112a14c770ec5b7f907fd95b5c13c,3HFWPF5AK9R4YZGT9MMAXJ25DRE3SH,0.15,1586.0,Anita,3600,56,145,56,110,0,35,0.15604166666666666,1
MTURK,112a14c770ec5b7f907fd95b5c13c,3OPLMF3EU5VOYQED7W9OUBMGQEWNL2,0.15,1586.0,Anita,3600,75,362,65,224,10,138,0.16508333333333333,1
MTURK,112a14c770ec5b7f907fd95b5c13c,37NXA7GVSTE16VNM9NVF4SGTCHYLVH,0.15,1585.0,Anita,3600,78,298,65,173,13,125,0.16241666666666665,1
MTURK,112a14c770ec5b7f907fd95b5c13c,3CO05SML7VDWGSHJBA4M5BZ2ODAR0L,0.15,1585.0,Anita,3600,76,122,73,78,3,44,0.15508333333333332,1
MTURK,112a14c770ec5b7f907fd95b5c13c,3LVTFB9DE5QTFVD4CX4PLDCDZ8XGQC,0.15,1585.0,Anita,3600,34,45,33,36,1,9,0.15187499999999998,1
MTURK,112a14c770ec5b7f907fd95b5c13c,3QREJ3J4335NQKTAAJH82J5CWJRLKV,0.15,1585.0,Anita,3600,51,90,51,60,0,30,0.15375,1
MTURK,112a14c770ec5b7f907fd95b5c13c,3MIVREZQVH6YHH9N2OP4J5466PDQKO,0.15,1584.0,Anita,3600,52,64,52,50,0,14,0.15266666666666667,1
MTURK,112a14c770ec5b7f907fd95b5c13c,3IYI9285WS8ZCWTMFLOXYLFCNLDJCE,0.15,1584.0,Anita,3600,76,107,76,82,0,25,0.15445833333333334,1
MTURK,112a14c770ec5b7f907fd95b5c13c,3HUR21WDDUXDAJZGSHLNMLFA17AXYO,0.15,1584.0,Anita,3600,53,76,53,57,0,19,0.15316666666666667,1
MTURK,112a14c770ec5b7f907fd95b5c13c,3C8QQOM6JP9WKP3MAGWWP3QZ4F2LIK,0.15,1584.0,Anita,3600,57,53,57,41,0,12,0.15220833333333333,1
MTURK,112a14c770ec5b7f907fd95b5c13c,31J7RYECZLYLKJ7O29BQX49DNDRL1S,0.15,1584.0,Anita,3600,70,62,70,49,0,13,0.15258333333333332,1
MTURK,112a14c770ec5b7f907fd95b5c13c,3I01FDIL6MG9BS1S8WDGJABD6A3D2L,0.15,1584.0,Anita,3600,49,51,49,43,0,8,0.15212499999999998,1
MTURK,112a14c770ec5b7f907fd95b5c13c,38F60IALAGP9W7UBFZ9H5Q0KCY80T8,0.15,1584.0,Anita,3600,53,57,53,42,0,15,0.15237499999999998,1
MTURK,112a14c770ec5b7f907fd95b5c13c,3ICOHX7ENCJ77OCEP4KM640J9OL0EI,0.15,1584.0,Anita,3600,56,60,56,33,0,27,0.1525,1
MTURK,112a14c770ec5b7f907fd95b5c13c,3O4VWC1GEWEBZWX3MSDW5IBIH813J1,0.15,1585.0,Anita,3600,45,67,45,34,0,33,0.15279166666666666,1
MTURK,112a14c770ec5b7f907fd95b5c13c,33TGB4G0LPPHTX0MIBYOE4NVM5SXTZ,0.15,1586.0,Anita,3600,53,97,53,71,0,26,0.15404166666666666,1
MTURK,112a14c770ec5b7f907fd95b5c13c,3HA5ODM5KA0OA8ICTWSGGEUO4B6VS5,0.15,1587.0,Anita,3600,77,99,77,80,0,19,0.15412499999999998,1
MTURK,112a14c770ec5b7f907fd95b5c13c,3BA7SXOG1JYEYHMM6EH1YQ5K7BMR88,0.15,1587.0,Anita,3600,53,44,53,31,0,13,0.15183333333333332,1
MTURK,112a14c770ec5b7f907fd95b5c13c,31SIZS5W59NK4LMIS8Y1KHQK1H8QRI,0.15,1587.0,Anita,3600,57,46,57,34,0,12,0.15191666666666667,1
MTURK,112a14c770ec5b7f907fd95b5c13c,3CRWSLD91KCQMTWA8NAG9D1AGTROMK,0.15,1585.0,Anita,3600,66,124,66,85,0,39,0.15516666666666667,1
MTURK,112a14c770ec5b7f907fd95b5c13c,3VDI8GSXAF1N9RD8Q3NPZMRD52BG81,0.15,1585.0,Anita,3600,83,180,83,118,0,62,0.1575,1
MTURK,112a14c770ec5b7f907fd95b5c13c,38F60IALAGP9W7UBFZ9H5Q0KCY7T00,0.15,1585.0,Anita,3600,44,62,44,35,0,27,0.15258333333333332,1
MTURK,112a14c770ec5b7f907fd95b5c13c,37Y5RYYI0PDGEXN7TBTY4ZR9KMESX5,0.15,1580.0,Anita,3600,78,3142,66,130,12,3012,0.28091666666666665,1
MTURK,112a14c770ec5b7f907fd95b5c13c,3CO05SML7VDWGSHJBA4M5BZ2ODB0RV,0.15,1580.0,Anita,3600,38,43,38,34,0,9,0.15179166666666666,1
MTURK,112a14c770ec5b7f907fd95b5c13c,35ZRNT9RUI6P07O02551DES4G2B3OK,0.15,1580.0,Anita,3600,63,47,63,37,0,10,0.15195833333333333,1
MTURK,112a14c770ec5b7f907fd95b5c13c,3XU9MCX6VOK3C2KXQX80OZSHLBUR25,0.15,1580.0,Anita,3600,46,35,46,29,0,6,0.15145833333333333,1
MTURK,112a14c770ec5b7f907fd95b5c13c,3X2YVV51PUC1VDJN6NIS6FQTLKVW1W,0.15,1580.0,Anita,3600,68,112,59,71,9,41,0.15466666666666667,1
MTURK,112a14c770ec5b7f907fd95b5c13c,3ZRKL6Z1E8B5SBSH41TUGDREHWIGS1,0.15,1580.0,Anita,3600,78,126,69,75,9,51,0.15525,1
MTURK,112a14c770ec5b7f907fd95b5c13c,3Z33IC0JC0U65TMDKQSPZJPYCNHV9U,0.15,1579.0,Anita,3600,76,60,76,39,0,21,0.1525,1
MTURK,112a14c770ec5b7f907fd95b5c13c,3Z8UJEJOCZLMTKKU0GMJGOXFL3P396,0.15,1579.0,Anita,3600,52,41,52,32,0,9,0.15170833333333333,1
MTURK,112a14c770ec5b7f907fd95b5c13c,3CVDZS288H8WGGJH9KRQMJSWOS0FMP,0.15,1579.0,Anita,3600,49,52,49,41,0,11,0.15216666666666667,1
MTURK,112a14c770ec5b7f907fd95b5c13c,38EHZ67RIM02UGFCK4X844S8P70GMP,0.15,1579.0,Anita,3600,61,98,61,61,0,37,0.15408333333333332,1
MTURK,112a14c770ec5b7f907fd95b5c13c,36GJS3V78VYCT89RH7KGOC0RLD5JGO,0.15,1579.0,Anita,3600,83,110,83,67,0,43,0.15458333333333332,1
MTURK,112a14c770ec5b7f907fd95b5c13c,3ZVPAMTJWNBTRWS4PCTPQ3MIVUZRGO,0.15,1579.0,Anita,3600,60,52,60,36,0,16,0.15216666666666667,1
MTURK,112a14c770ec5b7f907fd95b5c13c,3O4VWC1GEWEBZWX3MSDW5IBIH80J3G,0.15,1579.0,Anita,3600,66,50,66,37,0,13,0.15208333333333332,1
MTURK,112a14c770ec5b7f907fd95b5c13c,3AA88CN98PB7QJ09TY6YWR785YVYK0,0.15,1579.0,Anita,3600,47,32,47,23,0,9,0.15133333333333332,1
MTURK,112a14c770ec5b7f907fd95b5c13c,341H3G5YF0M5IJ3ALRYZRE11XUU0ZO,0.15,1579.0,Anita,3600,64,47,64,35,0,12,0.15195833333333333,1
MTURK,112a14c770ec5b7f907fd95b5c13c,3XEIP58NL0VIFFSWAKKIPYTP0S4LZH,0.15,1579.0,Anita,3600,46,37,46,30,0,7,0.15154166666666666,1
MTURK,112a14c770ec5b7f907fd95b5c13c,33BFF6QPI1JX5GX2TRWBU85QJ49W3O,0.15,1579.0,Anita,3600,46,64,46,50,0,14,0.15266666666666667,1
MTURK,112a14c770ec5b7f907fd95b5c13c,35F6NGNVM8RNEIUV0YUQK5A7KCDT70,0.15,1579.0,Anita,3600,45,54,45,45,0,9,0.15225,1
MTURK,112a14c770ec5b7f907fd95b5c13c,35U0MRQMUJF9CGQJMFB7W9KN7M3OV1,0.15,1579.0,Anita,3600,48,66,48,50,0,16,0.15275,1
MTURK,112a14c770ec5b7f907fd95b5c13c,3MJ28H2Y1EGSEMB4GOTUSBQOUY1O5U,0.15,1577.0,Anita,3600,45,76,45,63,0,13,0.15316666666666667,1
MTURK,112a14c770ec5b7f907fd95b5c13c,3D17ECOUOE344FHZW37Q1IFWNR113V,0.15,1577.0,Anita,3600,50,79,50,66,0,13,0.15329166666666666,1
MTURK,112a14c770ec5b7f907fd95b5c13c,3DFYDSXB2W8VYQAM1C9XSR1IULKJUO,0.15,1576.0,Anita,3600,65,68,65,52,0,16,0.15283333333333332,1
MTURK,112a14c770ec5b7f907fd95b5c13c,31MCUE39BKU18U72EMST85J2PGJG39,0.15,1576.0,Anita,3600,46,42,46,32,0,10,0.15175,1
MTURK,112a14c770ec5b7f907fd95b5c13c,3L21G7IH4745KIENLO0GRCB9WSVY1X,0.15,1574.0,Anita,3600,48,56,48,42,0,14,0.15233333333333332,1
MTURK,112a14c770ec5b7f907fd95b5c13c,3VLL1PIENQWQL0VTNC0AHFXJVX9OZ1,0.15,1574.0,Anita,3600,59,98,59,68,0,30,0.15408333333333332,1
MTURK,112a14c770ec5b7f907fd95b5c13c,3WRKFXQBOBFGKOALTVLMJBSVDU6YIP,0.15,1574.0,Anita,3600,80,135,80,102,0,33,0.15562499999999999,1
MTURK,112a14c770ec5b7f907fd95b5c13c,3M93N4X8HKVFJDIIC7EXDQJU9OZSJH,0.15,1574.0,Anita,3600,57,84,57,71,0,13,0.1535,1
MTURK,112a14c770ec5b7f907fd95b5c13c,3Q2T3FD0ONG1043OPPQOLA3ZL2VM3N,0.15,1551.0,Anita,3600,76,2488,46,85,30,2403,0.25366666666666665,1
MTURK,112a14c770ec5b7f907fd95b5c13c,3FULMHZ7OU5MI0MSP3V7VFV5Z2R4MQ,0.15,1551.0,Anita,3600,85,2482,58,76,27,2406,0.2534166666666666,1
MTURK,112a14c770ec5b7f907fd95b5c13c,3YLPJ8OXXA1QQAJH98SWOXQ9M4K4XJ,1.51,1776.0,User Surveys,3600,30,766,16,693,14,73,1.8312944444444446,1
MTURK,112a14c770ec5b7f907fd95b5c13c,3VGET1QSZ07F6ZYPV3Z17PH6O6VW7T,0.15,1469.0,Anita,3600,28,32,28,26,0,6,0.15133333333333332,1
MTURK,112a14c770ec5b7f907fd95b5c13c,375VSR8FVWHTIDN9F4HEBA2O6KTRZD,0.15,1469.0,Anita,3600,61,63,61,39,0,24,0.15262499999999998,1
MTURK,112a14c770ec5b7f907fd95b5c13c,3YCT0L9OMMHB2393R56P6X0BI84SNL,0.15,1469.0,Anita,3600,67,62,67,38,0,24,0.15258333333333332,1
MTURK,112a14c770ec5b7f907fd95b5c13c,3KTZHH2ONINN119U16LKCRBA1ONM8F,0.15,1469.0,Anita,3600,46,43,46,33,0,10,0.15179166666666666,1
MTURK,112a14c770ec5b7f907fd95b5c13c,3OJX0UFJ0ZF6SEXDF0IK3XNFYG89UJ,0.15,1467.0,Anita,3600,65,71,64,54,1,17,0.15295833333333334,1
MTURK,112a14c770ec5b7f907fd95b5c13c,3NKW03WTLMFPCH34R2877GY1TWNQWL,0.15,1467.0,Anita,3600,51,57,51,45,0,12,0.15237499999999998,1
MTURK,112a14c770ec5b7f907fd95b5c13c,3Q9SPIIRWJUXP1WN26BLHGJWPE1WAK,0.15,1467.0,Anita,3600,44,51,43,41,1,10,0.15212499999999998,1
MTURK,112a14c770ec5b7f907fd95b5c13c,3RWB1RTQDJVTM467TMDCTV556TZ8PY,0.15,1467.0,Anita,3600,64,86,61,48,3,38,0.15358333333333332,1
MTURK,112a14c770ec5b7f907fd95b5c13c,3KI0JD2ZU1QHCKJJ4LMX9VIT043673,0.15,1467.0,Anita,3600,53,71,50,36,3,35,0.15295833333333334,1
MTURK,112a14c770ec5b7f907fd95b5c13c,3ZZAYRN1I6ZUZOMUHKBSVRW2A1NOTL,0.15,1467.0,Anita,3600,41,50,41,41,0,9,0.15208333333333332,1
MTURK,112a14c770ec5b7f907fd95b5c13c,3PUV2Q8SV4C3Z51ORP6RK3EH0GGDBN,0.15,1467.0,Anita,3600,59,68,59,54,0,14,0.15283333333333332,1
MTURK,112a14c770ec5b7f907fd95b5c13c,38LRF35D5L4KDC8XYRHACKKTYOZ3UX,0.15,1467.0,Anita,3600,42,44,42,35,0,9,0.15183333333333332,1
MTURK,112a14c770ec5b7f907fd95b5c13c,3LCXHSGDLTE78XWQY636GA624G3SEW,0.15,1466.0,Anita,3600,49,55,49,45,0,10,0.15229166666666666,1
MTURK,112a14c770ec5b7f907fd95b5c13c,3EGKVCRQFW06XGWFNLT5XOOII4MYBG,0.15,1465.0,Anita,3600,53,70,53,58,0,12,0.15291666666666667,1
MTURK,112a14c770ec5b7f907fd95b5c13c,3ICOHX7ENCJ77OCEP4KM640J9OKE0V,0.15,1465.0,Anita,3600,48,81,48,69,0,12,0.15337499999999998,1
MTURK,112a14c770ec5b7f907fd95b5c13c,3WGCNLZJKFG2M7JWPSD2ER18E4Q1DT,0.15,1464.0,Anita,3600,58,65,58,48,0,17,0.15270833333333333,1
MTURK,112a14c770ec5b7f907fd95b5c13c,3OYHVNTV5T6VW5W7NBX0U096ROWKOB,0.15,1464.0,Anita,3600,40,51,40,41,0,10,0.15212499999999998,1
MTURK,112a14c770ec5b7f907fd95b5c13c,3QTFNPMJC6Q83FVHMX0X2QXE5N4NZL,0.15,1463.0,Anita,3600,67,64,67,49,0,15,0.15266666666666667,1
MTURK,112a14c770ec5b7f907fd95b5c13c,3MZ3TAMYTLV7NNYZF0TSBFZYA7RRIG,0.15,1462.0,Anita,3600,49,49,49,40,0,9,0.15204166666666666,1
MTURK,112a14c770ec5b7f907fd95b5c13c,3PMR2DOWOO9OAT1MX4ELEDKJD71541,0.15,1463.0,Anita,3600,44,39,44,29,0,10,0.15162499999999998,1
MTURK,112a14c770ec5b7f907fd95b5c13c,378G7J1SJL60FEDZIBD7DZ9NATZWEF,0.15,1460.0,Anita,3600,57,72,57,39,0,33,0.153,1
MTURK,112a14c770ec5b7f907fd95b5c13c,3WRBLBQ2GRG5R285VZAA67LVM400GZ,0.15,1460.0,Anita,3600,43,55,43,30,0,25,0.15229166666666666,1
MTURK,112a14c770ec5b7f907fd95b5c13c,3MD8CKRQZZV3IYI5XIESNGEYNMGRJS,0.15,1460.0,Anita,3600,59,63,59,44,0,19,0.15262499999999998,1
MTURK,112a14c770ec5b7f907fd95b5c13c,386659BNTLP8NNI2DGP7ZKHPKFH100,0.15,1460.0,Anita,3600,47,49,47,38,0,11,0.15204166666666666,1
MTURK,112a14c770ec5b7f907fd95b5c13c,3Q2T3FD0ONG1043OPPQOLA3ZL2UM3M,0.15,1460.0,Anita,3600,47,58,47,45,0,13,0.15241666666666667,1
MTURK,112a14c770ec5b7f907fd95b5c13c,3KTCJ4SCVG95Q1P92LC5XHO2NII1MB,0.15,1459.0,Anita,3600,51,67,51,53,0,14,0.15279166666666666,1
MTURK,112a14c770ec5b7f907fd95b5c13c,3ZVPAMTJWNBTRWS4PCTPQ3MIVUZGRD,0.15,1459.0,Anita,3600,61,76,61,63,0,13,0.15316666666666667,1
MTURK,112a14c770ec5b7f907fd95b5c13c,36FFXPMST9W4UFVZHQU3H8TEZ7SOHB,0.15,1459.0,Anita,3600,40,49,40,40,0,9,0.15204166666666666,1
MTURK,112a14c770ec5b7f907fd95b5c13c,3IV1AEQ4DRLX0T39Y98SWZJTXUSJ88,0.15,1459.0,Anita,3600,57,53,57,34,0,19,0.15220833333333333,1
MTURK,112a14c770ec5b7f907fd95b5c13c,3BAWBGQGYL72RAYK5TU5LNYSHXT7VU,0.15,1459.0,Anita,3600,46,40,46,25,0,15,0.15166666666666667,1
MTURK,112a14c770ec5b7f907fd95b5c13c,3ZQA3IO31BZTQ4ALF1RIPLD7IIX1OQ,0.15,1459.0,Anita,3600,48,43,48,33,0,10,0.15179166666666666,1
MTURK,112a14c770ec5b7f907fd95b5c13c,3S1L4CQSFXDVEFASCH1LDSXWUBBAF0,0.15,1457.0,Anita,3600,52,60,52,43,0,17,0.1525,1
MTURK,112a14c770ec5b7f907fd95b5c13c,3IJ95K7NDXK8CY0CW5C8HJH8UXAGNP,0.15,1457.0,Anita,3600,65,78,65,60,0,18,0.15325,1
MTURK,112a14c770ec5b7f907fd95b5c13c,3MQKOF1EE2WVN8ZZMG2N7HR2AHYDW3,0.15,1457.0,Anita,3600,45,35,45,27,0,8,0.15145833333333333,1
MTURK,112a14c770ec5b7f907fd95b5c13c,3M67TQBQQHWMD5JF9V1T3WBLRDGA98,0.15,1456.0,Anita,3600,45,54,45,45,0,9,0.15225,1
MTURK,112a14c770ec5b7f907fd95b5c13c,3WRKFXQBOBFGKOALTVLMJBSVDU6IY9,0.15,1456.0,Anita,3600,70,62,70,47,0,15,0.15258333333333332,1
MTURK,112a14c770ec5b7f907fd95b5c13c,3GMLHYZ0LE5LTF5LNCA02EG67PTYUX,0.15,1456.0,Anita,3600,49,46,49,36,0,10,0.15191666666666667,1
MTURK,112a14c770ec5b7f907fd95b5c13c,3S8A4GJRD3BJNAKFMJPDF9YWMM9V6J,0.15,1454.0,Anita,3600,67,49,67,38,0,11,0.15204166666666666,1
MTURK,112a14c770ec5b7f907fd95b5c13c,3VJ4PFXFJ3FKXX7I76WKZSYZ4YQAUZ,0.15,1454.0,Anita,3600,51,36,51,29,0,7,0.1515,1
MTURK,112a14c770ec5b7f907fd95b5c13c,32XN26MTXZRLDUM66Q7QJZQ3ILM0L5,0.15,1453.0,Anita,3600,52,63,52,45,0,18,0.15262499999999998,1
MTURK,112a14c770ec5b7f907fd95b5c13c,3BDORL6HKKLGAKCZNQX60C13X27RCE,0.15,1454.0,Anita,3600,48,45,48,37,0,8,0.15187499999999998,1
MTURK,112a14c770ec5b7f907fd95b5c13c,3BJKPTD2QCKXW1EA9CSWPM17LO7RTX,0.15,1452.0,Anita,3600,77,77,77,55,0,22,0.15320833333333334,1
MTURK,112a14c770ec5b7f907fd95b5c13c,31MCUE39BKU18U72EMST85J2PGK3GX,0.15,1452.0,Anita,3600,52,44,52,35,0,9,0.15183333333333332,1
MTURK,112a14c770ec5b7f907fd95b5c13c,3J9UN9O9J30FI4Y635VD3KDBEWGJ0L,0.15,1452.0,Anita,3600,64,82,64,67,0,15,0.15341666666666667,1
MTURK,112a14c770ec5b7f907fd95b5c13c,3MVY4USGB6VJO2YCUPTX1P4UW9AISV,0.15,1452.0,Anita,3600,48,67,48,56,0,11,0.15279166666666666,1
MTURK,112a14c770ec5b7f907fd95b5c13c,3PKJ68EHDN4QT4421D2Y9CCS0DIJHN,0.15,1452.0,Anita,3600,45,53,45,37,0,16,0.15220833333333333,1
MTURK,112a14c770ec5b7f907fd95b5c13c,3FTID4TN8L6IAPIREYIZBRKNUY0LYQ,0.15,1452.0,Anita,3600,57,68,57,48,0,20,0.15283333333333332,1
MTURK,112a14c770ec5b7f907fd95b5c13c,35A1YQPVFEOII001ITGP8EU2IP25IG,0.15,1452.0,Anita,3600,37,42,37,34,0,8,0.15175,1
MTURK,112a14c770ec5b7f907fd95b5c13c,3HYV4299H04PPDHHK8X1ZJ61SMW8EC,0.15,1451.0,Anita,3600,42,49,42,40,0,9,0.15204166666666666,1
MTURK,112a14c770ec5b7f907fd95b5c13c,3NI0WFPPI9O3U9JZJM1OUG86SQX603,0.15,1451.0,Anita,3600,41,58,41,49,0,9,0.15241666666666667,1
MTURK,112a14c770ec5b7f907fd95b5c13c,36FQTHX3Z3Z5HDZRY00F7US593S3BG,0.15,1450.0,Anita,3600,55,79,55,67,0,12,0.15329166666666666,1
MTURK,112a14c770ec5b7f907fd95b5c13c,37SQU136V7W8UC3K9ZT7DP0ZP7N113,0.15,1450.0,Anita,3600,38,48,38,40,0,8,0.152,1
MTURK,112a14c770ec5b7f907fd95b5c13c,3OB6JN3A9QXTJ6OQ0FRK386FRGBRMW,0.15,1450.0,Anita,3600,43,54,43,32,0,22,0.15225,1
MTURK,112a14c770ec5b7f907fd95b5c13c,3SD15I2WD22ZB1IW29J7WE6DV2H36V,0.15,1450.0,Anita,3600,61,69,61,41,0,28,0.15287499999999998,1
MTURK,112a14c770ec5b7f907fd95b5c13c,32CAVSKPCEXO39UIBN3ROR5W04L1U3,0.15,1450.0,Anita,3600,38,40,38,28,0,12,0.15166666666666667,1
MTURK,112a14c770ec5b7f907fd95b5c13c,3SR6AEG6W51GOTZ1ND31JZRGDHRYHW,0.15,1450.0,Anita,3600,59,49,59,36,0,13,0.15204166666666666,1
MTURK,112a14c770ec5b7f907fd95b5c13c,3VCK0Q0PO5MB1UPRI3N5WRUSNGM0N7,0.15,1450.0,Anita,3600,69,60,69,45,0,15,0.1525,1
MTURK,112a14c770ec5b7f907fd95b5c13c,335VBRURDJ8P3I0RP03FZF1CCSFE98,0.15,1450.0,Anita,3600,51,44,51,35,0,9,0.15183333333333332,1
MTURK,112a14c770ec5b7f907fd95b5c13c,3KG2UQJ0MJWZPNUQZ1HKBXLA0KJQNU,0.15,1450.0,Anita,3600,44,37,44,28,0,9,0.15154166666666666,1
MTURK,112a14c770ec5b7f907fd95b5c13c,3B9XR6P1WE3G2R1G1LS2N19U50EBJ0,0.15,1450.0,Anita,3600,61,57,61,45,0,12,0.15237499999999998,1
MTURK,112a14c770ec5b7f907fd95b5c13c,367O8HRHKGGPGVZX90RT7OUBRR9S4Q,0.15,1449.0,Anita,3600,39,54,39,40,0,14,0.15225,1
MTURK,112a14c770ec5b7f907fd95b5c13c,37M4O367VJQ4EJQS38EH071JZYM5MW,0.15,1449.0,Anita,3600,46,61,46,41,0,20,0.15254166666666666,1
MTURK,112a14c770ec5b7f907fd95b5c13c,3D1UCPY6GGHMFF1KVOG5GS241X738H,0.15,1449.0,Anita,3600,43,69,43,56,0,13,0.15287499999999998,1
MTURK,112a14c770ec5b7f907fd95b5c13c,306W7JMRYY6RIA5XAHVBYB0GPPJ8BC,0.15,1449.0,Anita,3600,57,73,57,57,0,16,0.15304166666666666,1
MTURK,112a14c770ec5b7f907fd95b5c13c,3HEADTGN2P0C9TIZE7SBQ4PSI9NRVD,0.15,1449.0,Anita,3600,47,57,47,45,0,12,0.15237499999999998,1
MTURK,112a14c770ec5b7f907fd95b5c13c,3SD15I2WD22ZB1IW29J7WE6DV2H63Y,0.15,1449.0,Anita,3600,42,52,42,38,0,14,0.15216666666666667,1
MTURK,112a14c770ec5b7f907fd95b5c13c,32PT7WK7DMNYWAXBCWRL2KG5CO3D3W,0.15,1448.0,Anita,3600,41,62,41,40,0,22,0.15258333333333332,1
MTURK,112a14c770ec5b7f907fd95b5c13c,3IVEC1GSLP7FPTJOZOZDHPWLJON1J7,0.15,1448.0,Anita,3600,50,60,50,35,0,25,0.1525,1
MTURK,112a14c770ec5b7f907fd95b5c13c,3G3AJKPCXL0MCHB686JIPAIC8C5Y4A,0.15,1448.0,Anita,3600,63,61,63,41,0,20,0.15254166666666666,1
MTURK,112a14c770ec5b7f907fd95b5c13c,3Y40HMYLL1QWTAFBIGOYJ09X5JZXUQ,0.15,1448.0,Anita,3600,41,40,41,30,0,10,0.15166666666666667,1
MTURK,112a14c770ec5b7f907fd95b5c13c,32W3UF2EZOT99EA1CE1TSJQT5OO4C9,0.15,1447.0,Anita,3600,42,55,42,39,0,16,0.15229166666666666,1
MTURK,112a14c770ec5b7f907fd95b5c13c,3W0XM68YZP3A0DP6H9ZPI4WYYDN1K6,0.15,1445.0,Anita,3600,53,62,53,44,0,18,0.15258333333333332,1
MTURK,112a14c770ec5b7f907fd95b5c13c,363A7XIFV4UKACWICW6PVE0II5ZVA9,0.15,1445.0,Anita,3600,38,42,38,34,0,8,0.15175,1
MTURK,112a14c770ec5b7f907fd95b5c13c,3UUIU9GZC5D8REGCC5FTMLWBT6IT5L,0.15,1444.0,Anita,3600,40,45,40,33,0,12,0.15187499999999998,1
MTURK,112a14c770ec5b7f907fd95b5c13c,3ZQX1VYFTDDB14U6EM0X4V0FWO2O8W,0.15,1443.0,Anita,3600,53,60,53,43,0,17,0.1525,1
MTURK,112a14c770ec5b7f907fd95b5c13c,324N5FAHSXJQMP54ONJEPS3ENHTVKO,0.15,1442.0,Anita,3600,45,66,45,52,0,14,0.15275,1
MTURK,112a14c770ec5b7f907fd95b5c13c,3QE4DGPGBRJMQQQ6E0XCIAB83GF4GI,0.15,1441.0,Anita,3600,50,80,50,65,0,15,0.15333333333333332,1
MTURK,112a14c770ec5b7f907fd95b5c13c,3FULMHZ7OU5MI0MSP3V7VFV5Z2QM47,0.15,1441.0,Anita,3600,36,48,36,40,0,8,0.152,1
MTURK,112a14c770ec5b7f907fd95b5c13c,3XH7ZM9YX22ECM5WB6NFYM0VRH4R9X,0.15,1440.0,Anita,3600,46,56,46,38,0,18,0.15233333333333332,1
MTURK,112a14c770ec5b7f907fd95b5c13c,3ACRLU860NM8RBFONKHBQLW20SIEBI,0.15,1441.0,Anita,3600,45,72,45,44,0,28,0.153,1
MTURK,112a14c770ec5b7f907fd95b5c13c,33Q5P9PUSPUPCBYQX7RJMF326JQCZS,0.15,1441.0,Anita,3600,45,78,45,53,0,25,0.15325,1
MTURK,112a14c770ec5b7f907fd95b5c13c,30ZKOOGW2WE4O0GK5IM0OQT2T1T1AR,0.15,1439.0,Anita,3600,48,105,48,90,0,15,0.15437499999999998,1
MTURK,112a14c770ec5b7f907fd95b5c13c,3HUR21WDDUXDAJZGSHLNMLFA17AYXP,0.15,1439.0,Anita,3600,65,108,65,92,0,16,0.1545,1
MTURK,112a14c770ec5b7f907fd95b5c13c,39N6W9XWRDV2OX4Q37LJYZFFYHEYGX,0.15,1439.0,Anita,3600,46,42,46,34,0,8,0.15175,1
MTURK,112a14c770ec5b7f907fd95b5c13c,32TZXEA1OLSPMB03WHC9BN721RX41J,0.15,1440.0,Anita,3600,45,48,45,39,0,9,0.152,1
MTURK,112a14c770ec5b7f907fd95b5c13c,372AGES0I4D4DINUEMTTEPMDYKVRXG,0.15,1440.0,Anita,3600,50,62,50,51,0,11,0.15258333333333332,1
MTURK,112a14c770ec5b7f907fd95b5c13c,3RDTX9JRTY94U3LH2SP9T59VQ5A97G,0.15,1438.0,Anita,3600,42,75,42,66,0,9,0.15312499999999998,1
MTURK,112a14c770ec5b7f907fd95b5c13c,3ABAOCJ4R8CT759QN02KYIWAVU9QMU,0.15,1437.0,Anita,3600,55,111,55,100,0,11,0.15462499999999998,1
MTURK,112a14c770ec5b7f907fd95b5c13c,3H6W48L9F4X4C52PRPTI7B8RO01PWT,0.15,1437.0,Anita,3600,74,89,74,77,0,12,0.15370833333333334,1
MTURK,112a14c770ec5b7f907fd95b5c13c,3ZURAPD288VZKRXSGY8S2R4TQH61F4,0.15,1437.0,Anita,3600,45,40,45,33,0,7,0.15166666666666667,1
MTURK,112a14c770ec5b7f907fd95b5c13c,3BKZLF990Z7T1MY463QVSDJH44NYQS,0.15,1437.0,Anita,3600,49,53,49,43,0,10,0.15220833333333333,1
MTURK,112a14c770ec5b7f907fd95b5c13c,3UAU495MII09Z11JHP120NI4TFUOUC,0.15,1437.0,Anita,3600,47,62,47,51,0,11,0.15258333333333332,1
MTURK,112a14c770ec5b7f907fd95b5c13c,3XWUWJ18TLY4C6LGDBDBZTATB1IUUV,0.15,1436.0,Anita,3600,49,80,49,61,0,19,0.15333333333333332,1
MTURK,112a14c770ec5b7f907fd95b5c13c,3T8DUCXY0NERS1IOFVSAY11DF21T9C,0.15,1436.0,Anita,3600,53,85,53,64,0,21,0.15354166666666666,1
MTURK,112a14c770ec5b7f907fd95b5c13c,38VTL6WC4AL480F6MB2SU2OQ8815YN,0.15,1435.0,Anita,3600,45,65,45,45,0,20,0.15270833333333333,1
MTURK,112a14c770ec5b7f907fd95b5c13c,3J5XXLQDHMJKQRXX3HRF86MCCV83VM,0.15,1436.0,Anita,3600,43,66,43,47,0,19,0.15275,1
MTURK,112a14c770ec5b7f907fd95b5c13c,33J5JKFMK66SLJ1GHIX52JN4V3SQ3E,0.15,1436.0,Anita,3600,40,58,39,38,1,20,0.15241666666666667,1
MTURK,112a14c770ec5b7f907fd95b5c13c,38VTL6WC4AL480F6MB2SU2OQ880Y5F,0.15,1436.0,Anita,3600,67,73,66,48,1,25,0.15304166666666666,1
MTURK,112a14c770ec5b7f907fd95b5c13c,3L55D8AUFA5P7LOL1LP088U00PMYCN,0.15,1436.0,Anita,3600,45,29,45,21,0,8,0.15120833333333333,1
MTURK,112a14c770ec5b7f907fd95b5c13c,3J06WJ78HNS420ZGNRXLR1EV3F0VVA,0.15,1436.0,Anita,3600,50,46,50,35,0,11,0.15191666666666667,1
MTURK,112a14c770ec5b7f907fd95b5c13c,3MXX6RQ9EVDS33J5HJNZCJP0472P47,0.15,1436.0,Anita,3600,72,62,72,44,0,18,0.15258333333333332,1
MTURK,112a14c770ec5b7f907fd95b5c13c,3LB1BGHFL246T2QWN7KQXIU4OBMYT6,0.15,1436.0,Anita,3600,49,49,49,38,0,11,0.15204166666666666,1
MTURK,112a14c770ec5b7f907fd95b5c13c,385MDVINFCN8QUZRWCOYAFMFF1VWJ0,0.15,1435.0,Anita,3600,49,54,49,44,0,10,0.15225,1
MTURK,112a14c770ec5b7f907fd95b5c13c,32CXT5U14GB6E9E3A8C631S4EAR8UU,0.15,1434.0,Anita,3600,82,99,82,73,0,26,0.15412499999999998,1
MTURK,112a14c770ec5b7f907fd95b5c13c,39HYCOOPKOTZIW5LIEW0YJPBCFKMDL,0.15,1434.0,Anita,3600,61,76,61,55,0,21,0.15316666666666667,1
MTURK,112a14c770ec5b7f907fd95b5c13c,33BFF6QPI1JX5GX2TRWBU85QJ4A3WW,0.15,1434.0,Anita,3600,71,82,71,59,0,23,0.15341666666666667,1
MTURK,112a14c770ec5b7f907fd95b5c13c,38RHULDV9YNCVJFLEU3YYE7F2M6WIO,0.15,1434.0,Anita,3600,69,96,69,70,0,26,0.154,1
MTURK,112a14c770ec5b7f907fd95b5c13c,351S7I5UG94I30QD4BXBEW9OMPRJNW,0.15,1433.0,Anita,3600,62,77,62,60,0,17,0.15320833333333334,1
MTURK,112a14c770ec5b7f907fd95b5c13c,3I7SHAD35M4J1N4BR1TEYRFFQ4HM7S,0.15,1434.0,Anita,3600,76,82,76,59,0,23,0.15341666666666667,1
MTURK,112a14c770ec5b7f907fd95b5c13c,3RWO3EJELHHBB4MMU14XELIXSNSP1U,0.15,1434.0,Anita,3600,45,30,45,17,0,13,0.15125,1
MTURK,112a14c770ec5b7f907fd95b5c13c,3D7VY91L65563Z714I5U3T1B9U9BM4,0.15,1433.0,Anita,3600,46,46,46,35,0,11,0.15191666666666667,1
MTURK,112a14c770ec5b7f907fd95b5c13c,3GV1I4SEO9XGR58L8FN7S00UVO86LC,0.15,1433.0,Anita,3600,55,67,55,47,0,20,0.15279166666666666,1
MTURK,112a14c770ec5b7f907fd95b5c13c,3U74KRR67MTCH3MIG5BFG2WXKRITNB,0.15,1432.0,Anita,3600,58,80,58,60,0,20,0.15333333333333332,1
MTURK,112a14c770ec5b7f907fd95b5c13c,3OPLMF3EU5VOYQED7W9OUBMGQEWLN0,0.15,1432.0,Anita,3600,39,40,39,32,0,8,0.15166666666666667,1
MTURK,112a14c770ec5b7f907fd95b5c13c,3X2YVV51PUC1VDJN6NIS6FQTLKW1W2,0.15,1430.0,Anita,3600,63,87,63,74,0,13,0.15362499999999998,1
MTURK,112a14c770ec5b7f907fd95b5c13c,3ZZAYRN1I6ZUZOMUHKBSVRW2A1NTOQ,0.15,1430.0,Anita,3600,41,61,41,53,0,8,0.15254166666666666,1
MTURK,112a14c770ec5b7f907fd95b5c13c,304QEQWKZPSTJFP3JINIBGUXDQR0OM,0.15,1430.0,Anita,3600,47,50,47,36,0,14,0.15208333333333332,1
MTURK,112a14c770ec5b7f907fd95b5c13c,3SNR5F7R921IEJTUTU9SC80FVI2EIR,0.15,1429.0,Anita,3600,68,64,68,43,0,21,0.15266666666666667,1
MTURK,112a14c770ec5b7f907fd95b5c13c,3KL228NDMVU74SF9ZSKSPR04025GKK,0.15,1429.0,Anita,3600,45,40,45,31,0,9,0.15166666666666667,1
MTURK,112a14c770ec5b7f907fd95b5c13c,3XABXM4AJ1DEMG7MTZS1T0VFBPL8QP,0.15,1429.0,Anita,3600,48,55,48,37,0,18,0.15229166666666666,1
MTURK,112a14c770ec5b7f907fd95b5c13c,3CMV9YRYP39SF0NSSYHW145ZHURLJW,0.15,1427.0,Anita,3600,42,66,42,48,0,18,0.15275,1
MTURK,112a14c770ec5b7f907fd95b5c13c,3MVY4USGB6VJO2YCUPTX1P4UW9ASI5,0.15,1427.0,Anita,3600,42,70,42,54,0,16,0.15291666666666667,1
MTURK,112a14c770ec5b7f907fd95b5c13c,3QQUBC64ZEMJYKV2LFCC55H3XN6NXO,0.15,1426.0,Anita,3600,47,86,47,69,0,17,0.15358333333333332,1
MTURK,112a14c770ec5b7f907fd95b5c13c,3EHIMLB7F7719N8JA957KM3EK2OH81,0.15,1426.0,Anita,3600,46,74,46,59,0,15,0.15308333333333332,1
MTURK,112a14c770ec5b7f907fd95b5c13c,3MA5N0ATTCJ31E59EXOABUMSUQVWKZ,0.15,1427.0,Anita,3600,49,82,49,70,0,12,0.15341666666666667,1
MTURK,112a14c770ec5b7f907fd95b5c13c,3UQ1LLR26AGHE7KOYS4J852GR7XAL5,0.15,1427.0,Anita,3600,52,81,52,72,0,9,0.15337499999999998,1
MTURK,112a14c770ec5b7f907fd95b5c13c,3JMNNNO3B1C8KY1JPRI6BY0YDQ9W2D,0.15,1427.0,Anita,3600,46,86,46,78,0,8,0.15358333333333332,1
MTURK,112a14c770ec5b7f907fd95b5c13c,3K8CQCU3KE949KQCBAGQ3M3WOL0WN4,0.15,1427.0,Anita,3600,64,113,64,98,0,15,0.15470833333333334,1
MTURK,112a14c770ec5b7f907fd95b5c13c,3WA2XVDZEMP2LZYTRT03F5AAMR76EP,0.15,1427.0,Anita,3600,49,82,49,70,0,12,0.15341666666666667,1
MTURK,112a14c770ec5b7f907fd95b5c13c,341H3G5YF0M5IJ3ALRYZRE11XUTZ0M,0.15,1426.0,Anita,3600,51,48,51,36,0,12,0.152,1
MTURK,112a14c770ec5b7f907fd95b5c13c,3APP19WN71M05DUKXOQRF8VMZ7LG6F,0.15,1427.0,Anita,3600,62,66,62,52,0,14,0.15275,1
MTURK,112a14c770ec5b7f907fd95b5c13c,3H1C3QRA01RR1G7U1KD6152KIDIECP,0.15,1427.0,Anita,3600,42,42,42,35,0,7,0.15175,1
MTURK,112a14c770ec5b7f907fd95b5c13c,3VI0PC2ZAYS1G5VEMUCPKUH8NXBOX4,0.15,1426.0,Anita,3600,52,64,52,28,0,36,0.15266666666666667,1
MTURK,112a14c770ec5b7f907fd95b5c13c,31MBOZ6PAOZ57MHMI60AE0S4RAILCI,0.15,1426.0,Anita,3600,69,86,69,47,0,39,0.15358333333333332,1
MTURK,112a14c770ec5b7f907fd95b5c13c,3WPCIUYH1AG3VRV5RBXCKXK36NGDTD,0.15,1425.0,Anita,3600,68,54,68,36,0,18,0.15225,1
MTURK,112a14c770ec5b7f907fd95b5c13c,3CESM1J3EIBW2ZKKCTU91BHATVBW6U,0.15,1425.0,Anita,3600,51,40,51,25,0,15,0.15166666666666667,1
MTURK,112a14c770ec5b7f907fd95b5c13c,3SA4EMRVJVAB4F14YI0X0GZNNVN0P3,0.15,1425.0,Anita,3600,44,44,44,22,0,22,0.15183333333333332,1
MTURK,112a14c770ec5b7f907fd95b5c13c,3N2YPY1GI66N0PDUS18BRXQ93KXVE4,0.15,1423.0,Anita,3600,66,60,66,31,0,29,0.1525,1
MTURK,112a14c770ec5b7f907fd95b5c13c,3MDWE879UHARWFO7F91PY7VR9V1B94,0.15,1423.0,Anita,3600,45,39,45,28,0,11,0.15162499999999998,1
MTURK,112a14c770ec5b7f907fd95b5c13c,3EHVO81VN5TJYNOYBOWS5CG66WJ1H2,0.15,1425.0,Anita,3600,54,51,54,32,0,19,0.15212499999999998,1
MTURK,112a14c770ec5b7f907fd95b5c13c,3VEI3XUCZR5Z49L3SVJCKC0AWLMRPS,0.15,1423.0,Anita,3600,71,69,71,47,0,22,0.15287499999999998,1
MTURK,112a14c770ec5b7f907fd95b5c13c,39O0SQZVJNFAY3H3W9PVKQ9PWRGR7L,0.15,1423.0,Anita,3600,44,44,44,35,0,9,0.15183333333333332,1
MTURK,112a14c770ec5b7f907fd95b5c13c,33N1S8XHHMT5P8OSHA2Z5JKB2M01ZS,0.15,1423.0,Anita,3600,68,66,68,43,0,23,0.15275,1
MTURK,112a14c770ec5b7f907fd95b5c13c,3TD33TP5DLA51YYC7FFPU26BFDJBAJ,0.15,1423.0,Anita,3600,45,54,45,38,0,16,0.15225,1
MTURK,112a14c770ec5b7f907fd95b5c13c,3RTFSSG7T8EELKNRZX0BQUZ7JQ0WL2,0.15,1423.0,Anita,3600,47,35,47,26,0,9,0.15145833333333333,1
MTURK,112a14c770ec5b7f907fd95b5c13c,39KV3A5D18FMZIHGBYP0A0ELITZS7A,0.15,1423.0,Anita,3600,44,49,44,39,0,10,0.15204166666666666,1
MTURK,112a14c770ec5b7f907fd95b5c13c,3FO95NVK5C8WH11VKCN6FH5LJ5TSR9,0.15,1417.0,Anita,3600,83,700,83,665,0,35,0.17916666666666667,1
MTURK,112a14c770ec5b7f907fd95b5c13c,3KVQ0UJWPXT0JVK67AK4953AX00W5E,0.15,1417.0,Anita,3600,62,685,62,656,0,29,0.17854166666666665,1
MTURK,112a14c770ec5b7f907fd95b5c13c,3S4TINXCC0VU32SDHYK7VXQG4UNOBV,0.15,1417.0,Anita,3600,46,43,46,33,0,10,0.15179166666666666,1
MTURK,112a14c770ec5b7f907fd95b5c13c,3D5G8J4N5ACPP8VRIWX6QJQA6UKVTU,0.15,1417.0,Anita,3600,70,60,70,42,0,18,0.1525,1
MTURK,112a14c770ec5b7f907fd95b5c13c,31KSVEGZ340POII44HX7C686PIPWRS,0.15,1417.0,Anita,3600,48,42,48,31,0,11,0.15175,1
MTURK,112a14c770ec5b7f907fd95b5c13c,3UY4PIS8QRTB8JA9EMR5AWD2S8S1NB,0.15,1414.0,Anita,3600,52,65,52,42,0,23,0.15270833333333333,1
MTURK,112a14c770ec5b7f907fd95b5c13c,3YO4AH2FPDSW4R2JYVFM0LPXSR90QU,0.15,1417.0,Anita,3600,54,50,54,26,0,24,0.15208333333333332,1
MTURK,112a14c770ec5b7f907fd95b5c13c,3PN6H8C9R4YYGVWWLB6VPSUBIYVDAS,0.15,1413.0,Anita,3600,69,68,69,55,0,13,0.15283333333333332,1
MTURK,112a14c770ec5b7f907fd95b5c13c,3QMELQS6Y5JRU33YDZK3EC9T1GWR6M,0.15,1413.0,Anita,3600,50,54,50,45,0,9,0.15225,1
MTURK,112a14c770ec5b7f907fd95b5c13c,309D674SHZTTUDVARTBG0XWZFG4BCL,0.15,1413.0,Anita,3600,64,55,64,44,0,11,0.15229166666666666,1
MTURK,112a14c770ec5b7f907fd95b5c13c,302U8RURJZ9RUVQ7L0BUHKKIHCYNVL,0.15,1413.0,Anita,3600,47,38,47,31,0,7,0.15158333333333332,1
MTURK,112a14c770ec5b7f907fd95b5c13c,371DNNCG44AREWZEA3MWY562VWK8T3,0.15,1412.0,Anita,3600,68,50,68,33,0,17,0.15208333333333332,1
MTURK,112a14c770ec5b7f907fd95b5c13c,3B6F54KMR2K8OW2EMI8R9QN8F701SN,0.15,1412.0,Anita,3600,51,30,51,17,0,13,0.15125,1
MTURK,112a14c770ec5b7f907fd95b5c13c,3DA79LNS5935DZT8YMR07OYRFART3V,0.15,1412.0,Anita,3600,56,46,56,36,0,10,0.15191666666666667,1
MTURK,112a14c770ec5b7f907fd95b5c13c,3Z3R5YC0P3V0TB91IHS28XNOI0WTF4,0.15,1412.0,Anita,3600,89,61,89,42,0,19,0.15254166666666666,1
MTURK,112a14c770ec5b7f907fd95b5c13c,3126F2F5F8BAV5GY6PZCL51RHWXEP3,0.15,1412.0,Anita,3600,56,44,56,32,0,12,0.15183333333333332,1
MTURK,112a14c770ec5b7f907fd95b5c13c,3DIIW4IV8P30MHW14OXF3MOOIT84IB,0.15,1412.0,Anita,3600,47,33,47,22,0,11,0.15137499999999998,1
MTURK,112a14c770ec5b7f907fd95b5c13c,39TX062QX1WCUG2S3WSXWRJXS6G3XP,0.15,1412.0,Anita,3600,66,47,66,33,0,14,0.15195833333333333,1
MTURK,112a14c770ec5b7f907fd95b5c13c,39WSF6KUV2TSA54XRPMXW5W17R0OEV,0.15,1412.0,Anita,3600,45,53,45,35,0,18,0.15220833333333333,1
MTURK,112a14c770ec5b7f907fd95b5c13c,3ODOP6T3ASSWBWIZFLCNG6H7TXB420,0.15,1412.0,Anita,3600,52,69,52,47,0,22,0.15287499999999998,1
MTURK,112a14c770ec5b7f907fd95b5c13c,3D42WVSDH83WAX8VSNF1GEF3X2EYFY,0.15,1412.0,Anita,3600,71,62,71,47,0,15,0.15258333333333332,1
MTURK,112a14c770ec5b7f907fd95b5c13c,373L46LKP7EHVU5A7Y5VM4SKSUMJKR,0.15,1412.0,Anita,3600,52,37,52,29,0,8,0.15154166666666666,1
MTURK,112a14c770ec5b7f907fd95b5c13c,3YGYP13641HZ1O9QCG6KGNVFW6LRNW,0.15,1411.0,Anita,3600,45,55,45,42,0,13,0.15229166666666666,1
MTURK,112a14c770ec5b7f907fd95b5c13c,3TL87MO8CMXCAY1W98QBM6D7ONALFT,0.15,1408.0,Anita,3600,46,75,46,50,0,25,0.15312499999999998,1
MTURK,112a14c770ec5b7f907fd95b5c13c,31ODACBENUNW50MV7XY6ARVGNJRSQ8,0.15,1408.0,Anita,3600,64,111,64,78,0,33,0.15462499999999998,1
MTURK,112a14c770ec5b7f907fd95b5c13c,338431Z1FLNHJ992DV6XVCVKMGQROB,0.15,1408.0,Anita,3600,26,41,26,30,0,11,0.15170833333333333,1
MTURK,112a14c770ec5b7f907fd95b5c13c,3421H3BM9APXEYMJ31E6WVE4H0AJ9X,0.15,1408.0,Anita,3600,56,63,56,50,0,13,0.15262499999999998,1
MTURK,112a14c770ec5b7f907fd95b5c13c,3ZC62PVYDHIOAE96NLZL3781Z1GXXI,0.15,1405.0,Anita,3600,62,78,62,64,0,14,0.15325,1
MTURK,112a14c770ec5b7f907fd95b5c13c,3GVPRXWRPH2X54EK6MVM6Y8Y9VXI78,0.15,1405.0,Anita,3600,60,74,60,60,0,14,0.15308333333333332,1
MTURK,112a14c770ec5b7f907fd95b5c13c,3PIOQ99R7YURHG17GA1PLYIZ35PNUW,0.15,1405.0,Anita,3600,41,50,41,42,0,8,0.15208333333333332,1
MTURK,112a14c770ec5b7f907fd95b5c13c,3909MD9T2ZPY4SR4SM379BNNFQAEF0,0.15,1405.0,Anita,3600,42,86,42,67,0,19,0.15358333333333332,1
MTURK,112a14c770ec5b7f907fd95b5c13c,3KA7IJSNW6DCO24EWYXMKXV6EZKBP0,0.15,1405.0,Anita,3600,56,101,56,79,0,22,0.15420833333333334,1
MTURK,112a14c770ec5b7f907fd95b5c13c,33K3E8REWW3YVD8YFDNTN8R88S88XM,0.15,1404.0,Anita,3600,46,67,46,57,0,10,0.15279166666666666,1
MTURK,112a14c770ec5b7f907fd95b5c13c,3NSM4HLQNR2KSK7IFT91FRGF5V6QQH,0.15,1405.0,Anita,3600,41,73,41,57,0,16,0.15304166666666666,1
MTURK,112a14c770ec5b7f907fd95b5c13c,3CVDZS288H8WGGJH9KRQMJSWOS0MFW,0.15,1404.0,Anita,3600,58,87,58,68,0,19,0.15362499999999998,1
MTURK,112a14c770ec5b7f907fd95b5c13c,3511RHPADVM9DO6503Q53VRQRBLRLU,0.15,1404.0,Anita,3600,37,48,37,41,0,7,0.152,1
MTURK,112a14c770ec5b7f907fd95b5c13c,34HEO7RUG62SH5F13C1FUHBFXZMRAC,0.15,1404.0,Anita,3600,55,69,55,38,0,31,0.15287499999999998,1
MTURK,112a14c770ec5b7f907fd95b5c13c,388FBO7JZR18YPLCQBYEOJOCZT0NYU,0.15,1404.0,Anita,3600,72,86,72,52,0,34,0.15358333333333332,1
MTURK,112a14c770ec5b7f907fd95b5c13c,3XDJY5RK5ST5V8R1Y5MTMPCZCOUU48,0.15,1404.0,Anita,3600,44,52,44,42,0,10,0.15216666666666667,1
MTURK,112a14c770ec5b7f907fd95b5c13c,360ZO6N6J1RNF6S46YRYCN6LLU5M94,0.15,1403.0,Anita,3600,65,60,65,43,0,17,0.1525,1
MTURK,112a14c770ec5b7f907fd95b5c13c,3087LXLJ6MOZD2CAKF4SOMLJLP00F0,0.15,1403.0,Anita,3600,45,49,45,38,0,11,0.15204166666666666,1
MTURK,112a14c770ec5b7f907fd95b5c13c,3L7SUC0TTU25JC4R6285JC5SIQC0M7,0.15,1402.0,Anita,3600,45,53,45,41,0,12,0.15220833333333333,1
MTURK,112a14c770ec5b7f907fd95b5c13c,35JDMRECC4H4ISNZ369PRWNZG59GE0,0.15,1402.0,Anita,3600,50,67,50,41,0,26,0.15279166666666666,1
MTURK,112a14c770ec5b7f907fd95b5c13c,3CZH926SICMO6CUF857OI7QWQ014E2,0.15,1402.0,Anita,3600,41,77,41,53,0,24,0.15320833333333334,1
MTURK,112a14c770ec5b7f907fd95b5c13c,3LOJFQ4BOXN4S85IX2JKJ6X7NAPDK7,0.15,1402.0,Anita,3600,42,99,42,72,0,27,0.15412499999999998,1
MTURK,112a14c770ec5b7f907fd95b5c13c,35JDMRECC4H4ISNZ369PRWNZG5AEGZ,0.15,1402.0,Anita,3600,60,113,60,85,0,28,0.15470833333333334,1
MTURK,112a14c770ec5b7f907fd95b5c13c,30QQTY5GMKS2EV9K03K0P1W93QKU7S,0.15,1402.0,Anita,3600,62,78,62,64,0,14,0.15325,1
MTURK,112a14c770ec5b7f907fd95b5c13c,3B9XR6P1WE3G2R1G1LS2N19U50DJB7,0.15,1402.0,Anita,3600,42,49,42,40,0,9,0.15204166666666666,1
MTURK,112a14c770ec5b7f907fd95b5c13c,3EQVJH0T40TK7707D7G2BIZ1YF9TH2,0.15,1402.0,Anita,3600,43,58,43,50,0,8,0.15241666666666667,1
MTURK,112a14c770ec5b7f907fd95b5c13c,3TKXBROM5TIQPZFM7VKJ9OD70QXJIG,0.15,1402.0,Anita,3600,40,71,40,58,0,13,0.15295833333333334,1
MTURK,112a14c770ec5b7f907fd95b5c13c,362E9TQF2HYGYXPLZPZGCBLR8YGGI9,0.15,1401.0,Anita,3600,50,117,50,98,0,19,0.15487499999999998,1
MTURK,112a14c770ec5b7f907fd95b5c13c,38B7Q9C28GDLQ37CJIKHNR9ZVUR96I,0.15,1400.0,Anita,3600,56,138,56,122,0,16,0.15575,1
MTURK,112a14c770ec5b7f907fd95b5c13c,3GL25Y68432DG2A29EXCSQS3SXWXMY,0.15,1399.0,Anita,3600,52,90,52,71,0,19,0.15375,1
MTURK,112a14c770ec5b7f907fd95b5c13c,3HJ1EVZS2ORSXKGGUXM579X9RPUR3G,0.15,1400.0,Anita,3600,58,71,58,53,0,18,0.15295833333333334,1
MTURK,112a14c770ec5b7f907fd95b5c13c,33TGB4G0LPPHTX0MIBYOE4NVM5STXV,0.15,1399.0,Anita,3600,61,71,61,60,0,11,0.15295833333333334,1
MTURK,112a14c770ec5b7f907fd95b5c13c,3M7OI89LVYWNO1EFV2U8PHA71FUC62,0.15,1399.0,Anita,3600,38,48,38,42,0,6,0.152,1
MTURK,112a14c770ec5b7f907fd95b5c13c,3P520RYKCHENRRV1CA53RHIDCKPU5D,0.15,1310.0,Anita,3600,68,1897,68,1845,0,52,0.22904166666666664,1
MTURK,112a14c770ec5b7f907fd95b5c13c,3E6L1VR4XWUURDYPM4K9XNVAYSM6F7,0.15,1310.0,Anita,3600,51,62,51,50,0,12,0.15258333333333332,1
MTURK,112a14c770ec5b7f907fd95b5c13c,3RWO3EJELHHBB4MMU14XELIXSNT1P7,0.15,1306.0,Anita,3600,69,47,69,33,0,14,0.15195833333333333,1
MTURK,112a14c770ec5b7f907fd95b5c13c,38LRF35D5L4KDC8XYRHACKKTYOYU3N,0.15,1306.0,Anita,3600,51,32,51,22,0,10,0.15133333333333332,1
MTURK,112a14c770ec5b7f907fd95b5c13c,3UZUVSO3P734A2JLE97K417WCRLMEE,0.15,1304.0,Anita,3600,104,196,104,150,0,46,0.15816666666666665,1
MTURK,112a14c770ec5b7f907fd95b5c13c,3V0TR1NRVAALGZD3S052MO055L34A7,0.15,1309.0,Anita,3600,64,154,64,120,0,34,0.15641666666666665,1
MTURK,112a14c770ec5b7f907fd95b5c13c,3G3AJKPCXL0MCHB686JIPAIC8C64YH,0.15,1296.0,Anita,3600,48,78,48,55,0,23,0.15325,1
MTURK,112a14c770ec5b7f907fd95b5c13c,36BTXXLZ2VGDFGZKUBROHEPF5PR4RF,0.15,1296.0,Anita,3600,64,79,64,58,0,21,0.15329166666666666,1
MTURK,112a14c770ec5b7f907fd95b5c13c,371QPA24C2W93WFTBIDHJVJUHQE1TC,0.15,1296.0,Anita,3600,45,45,45,36,0,9,0.15187499999999998,1
MTURK,112a14c770ec5b7f907fd95b5c13c,3IHWR4LC7DL15IJ3GRNSKY4TKF38IL,0.15,1290.0,Anita,3600,64,47,64,34,0,13,0.15195833333333333,1
MTURK,112a14c770ec5b7f907fd95b5c13c,3BCRDCM0OD257ZQ3NFB6D0NF6O36K9,0.15,1306.0,Anita,3600,64,61,64,45,0,16,0.15254166666666666,1
MTURK,112a14c770ec5b7f907fd95b5c13c,39O6Z4JLX25W6P4BN6Y3FMBGJQ8VXD,0.15,1306.0,Anita,3600,45,49,45,40,0,9,0.15204166666666666,1
MTURK,112a14c770ec5b7f907fd95b5c13c,3TX9T2ZCB99YQ94VEYRKY9A5YZ8WZL,0.15,1302.0,Anita,3600,48,76,48,50,0,26,0.15316666666666667,1
MTURK,112a14c770ec5b7f907fd95b5c13c,36AZSFEYZ48PTM1AIA6LQPKO0NKVB4,0.15,1290.0,Anita,3600,39,58,39,35,0,23,0.15241666666666667,1
MTURK,112a14c770ec5b7f907fd95b5c13c,3PZDSVZ3J5PS0I7S14A78UK54S24NR,0.15,1277.0,Anita,3600,51,62,51,44,0,18,0.15258333333333332,1
MTURK,112a14c770ec5b7f907fd95b5c13c,37VUR2VJ6AXSHFDIPWIRULJQT4E1CT,0.15,1277.0,Anita,3600,38,45,38,32,0,13,0.15187499999999998,1
MTURK,112a14c770ec5b7f907fd95b5c13c,3MQKOF1EE2WVN8ZZMG2N7HR2AHYWDM,0.15,1277.0,Anita,3600,39,44,39,35,0,9,0.15183333333333332,1
MTURK,112a14c770ec5b7f907fd95b5c13c,3OZ4VAIBEXNVB5ZM62J2OD318STVJP,0.15,1277.0,Anita,3600,43,59,43,42,0,17,0.15245833333333333,1
MTURK,112a14c770ec5b7f907fd95b5c13c,3YLPJ8OXX8LXCCLW3AXG6WB366C4XB,0.15,1286.0,Anita,3600,37,91,37,70,0,21,0.15379166666666666,1
MTURK,112a14c770ec5b7f907fd95b5c13c,3PMR2DOWOO9OAT1MX4ELEDKJD72451,0.15,1285.0,Anita,3600,46,100,46,83,0,17,0.15416666666666667,1
MTURK,112a14c770ec5b7f907fd95b5c13c,3LXX8KJXPWHBF9DGJE6B4RVQGUKO9L,0.15,1282.0,Anita,3600,54,59,54,45,0,14,0.15245833333333333,1
MTURK,112a14c770ec5b7f907fd95b5c13c,34YWR3PJ28IGDO3VK9AEUTLQPUVX0N,0.15,1282.0,Anita,3600,49,61,49,47,0,14,0.15254166666666666,1
MTURK,112a14c770ec5b7f907fd95b5c13c,3HA5ODM5KA0OA8ICTWSGGEUO4B6SV2,0.15,1271.0,Anita,3600,62,66,62,44,0,22,0.15275,1
MTURK,112a14c770ec5b7f907fd95b5c13c,3X7837UUAD6AWFKL5UBUCLN2RZ36JA,0.15,1271.0,Anita,3600,41,53,41,36,0,17,0.15220833333333333,1
MTURK,112a14c770ec5b7f907fd95b5c13c,3WRBLBQ2GRG5R285VZAA67LVM4ZG0E,0.15,1271.0,Anita,3600,50,75,50,63,0,12,0.15312499999999998,1
MTURK,112a14c770ec5b7f907fd95b5c13c,3087LXLJ6MOZD2CAKF4SOMLJLPZF0E,0.15,1276.0,Anita,3600,61,90,55,65,6,25,0.15375,1
MTURK,112a14c770ec5b7f907fd95b5c13c,3H1C3QRA01RR1G7U1KD6152KIDICEN,0.15,1251.0,Anita,3600,88,107,75,60,13,47,0.15445833333333334,1
MTURK,112a14c770ec5b7f907fd95b5c13c,3UOMW19E6DER5XE1QJK3XBW75KJC5M,0.15,1255.0,Anita,3600,103,110,89,62,14,48,0.15458333333333332,1
MTURK,112a14c770ec5b7f907fd95b5c13c,3TZDZ3Y0JSEQJH6FDC80SVIINJB91K,0.15,1255.0,Anita,3600,57,41,56,29,1,12,0.15170833333333333,1
MTURK,112a14c770ec5b7f907fd95b5c13c,39I4RL8QGJP0QMLHY6FU3AN9IGT4HI,0.15,1245.0,Anita,3600,47,45,47,35,0,10,0.15187499999999998,1
MTURK,112a14c770ec5b7f907fd95b5c13c,3DWGDA5POFCOGOJIGDDWKD7FEBU1VS,0.15,1245.0,Anita,3600,52,59,52,46,0,13,0.15245833333333333,1
MTURK,112a14c770ec5b7f907fd95b5c13c,32FESTC2NHY8QC4GRKSB5NON41BCU3,0.15,1245.0,Anita,3600,42,74,42,39,0,35,0.15308333333333332,1
MTURK,112a14c770ec5b7f907fd95b5c13c,3AXFSPQOYQ66F8DW6NEY6R0FKY5JFP,0.15,1244.0,Anita,3600,48,84,48,47,0,37,0.1535,1
MTURK,112a14c770ec5b7f907fd95b5c13c,3BAKUKE49HKWNH217T8MJGICT5H1RZ,0.15,1244.0,Anita,3600,56,58,56,46,0,12,0.15241666666666667,1
MTURK,112a14c770ec5b7f907fd95b5c13c,3PEG1BH7AEZBDB7YJ6SEOG97KPEBKZ,0.15,1244.0,Anita,3600,41,35,41,27,0,8,0.15145833333333333,1
MTURK,112a14c770ec5b7f907fd95b5c13c,3P7QK0GJ3TTCET6O0E2DA2UGUSDZ26,0.15,1241.0,Anita,3600,51,52,51,41,0,11,0.15216666666666667,1
MTURK,112a14c770ec5b7f907fd95b5c13c,3X0EMNLXEPXRXG2K1FOML9PDHRZVPP,0.15,1241.0,Anita,3600,52,59,52,49,0,10,0.15245833333333333,1
MTURK,112a14c770ec5b7f907fd95b5c13c,3XABXM4AJ1DEMG7MTZS1T0VFBPKQ86,0.15,1236.0,Anita,3600,65,80,65,67,0,13,0.15333333333333332,1
MTURK,112a14c770ec5b7f907fd95b5c13c,3TC2K6WK9GAXUX51RO20XIXCVJ7285,0.15,1236.0,Anita,3600,45,56,45,47,0,9,0.15233333333333332,1
MTURK,112a14c770ec5b7f907fd95b5c13c,3P6ENY9P794UYTKWJVHYXBXSNYSIH9,0.15,1228.0,Anita,3600,65,83,65,47,0,36,0.15345833333333334,1
MTURK,112a14c770ec5b7f907fd95b5c13c,3SBX2M1TKDVD3FKKHW2OCOFA93P4QE,0.15,1228.0,Anita,3600,46,60,46,28,0,32,0.1525,1
MTURK,112a14c770ec5b7f907fd95b5c13c,3A3KKYU7P3PYR25CZ91QQ7EWJVQWM4,0.15,1229.0,Anita,3600,45,52,45,36,0,16,0.15216666666666667,1
MTURK,112a14c770ec5b7f907fd95b5c13c,3J9L0X0VDFUJKIMIA0XLLL8CJWJW95,0.15,1226.0,Anita,3600,52,69,52,50,0,19,0.15287499999999998,1
MTURK,112a14c770ec5b7f907fd95b5c13c,3PA41K45VNCPMQ1OJHL6FV9AV9SP7R,0.15,1226.0,Anita,3600,48,60,48,49,0,11,0.1525,1
MTURK,112a14c770ec5b7f907fd95b5c13c,3W1K7D6QSBP6266KJ7VOBVXKOYRBZL,0.15,1222.0,Anita,3600,49,77,49,62,0,15,0.15320833333333334,1
MTURK,112a14c770ec5b7f907fd95b5c13c,3VZYA8PITO67B5JLE3RJ2AU6WVM50M,0.15,1218.0,Anita,3600,45,85,45,69,0,16,0.15354166666666666,1
MTURK,112a14c770ec5b7f907fd95b5c13c,37AQKJ12TXWACGR2D1XRP12P994TTC,0.15,1209.0,Anita,3600,41,68,41,55,0,13,0.15283333333333332,1
MTURK,112a14c770ec5b7f907fd95b5c13c,3Q2T3FD0ONG1043OPPQOLA3ZL2W3M5,0.15,1219.0,Anita,3600,63,82,63,67,0,15,0.15341666666666667,1
MTURK,112a14c770ec5b7f907fd95b5c13c,30UZJB2POHK3SXIIXQ9248SDZ7653H,0.15,1214.0,Anita,3600,68,60,68,47,0,13,0.1525,1
MTURK,112a14c770ec5b7f907fd95b5c13c,3OND0WXMHWNIIOIANCR7CWZ0V5NEHY,0.15,1214.0,Anita,3600,46,42,46,33,0,9,0.15175,1
MTURK,112a14c770ec5b7f907fd95b5c13c,336OE47KI2SHHPZLD12HD3X9AO2WVL,0.15,1211.0,Anita,3600,45,57,45,49,0,8,0.15237499999999998,1
MTURK,112a14c770ec5b7f907fd95b5c13c,3FJ2RVH25ZEX82OBWG8EXESNFPP921,0.15,1211.0,Anita,3600,54,100,54,76,0,24,0.15416666666666667,1
MTURK,112a14c770ec5b7f907fd95b5c13c,3BFNCI9LYKYIF1W1LJOZ2S69QD137U,0.15,1208.0,Anita,3600,67,107,67,72,0,35,0.15445833333333334,1
MTURK,112a14c770ec5b7f907fd95b5c13c,356TQKY9XF54GY27X0JVT9EK6ZT78Q,0.15,1208.0,Anita,3600,49,49,49,32,0,17,0.15204166666666666,1
MTURK,112a14c770ec5b7f907fd95b5c13c,33K3E8REWW3YVD8YFDNTN8R88S7X8A,0.15,1204.0,Anita,3600,46,61,46,32,0,29,0.15254166666666666,1
MTURK,112a14c770ec5b7f907fd95b5c13c,3NBFJK3IOHQQUJ0OXKCLW8HDK7FGO4,0.15,1198.0,Anita,3600,49,47,49,30,0,17,0.15195833333333333,1
MTURK,112a14c770ec5b7f907fd95b5c13c,3JUDR1D0D6Z3015XDIJ0J9ICPPT2QG,0.15,1192.0,Anita,3600,45,72,45,42,0,30,0.153,1
MTURK,112a14c770ec5b7f907fd95b5c13c,379OL9DBSSMN9NHIP1F96ITSU4JY96,0.15,1193.0,Anita,3600,63,102,63,72,0,30,0.15425,1
MTURK,112a14c770ec5b7f907fd95b5c13c,3IKDQS3DQE83HL9GX33XMK0CA6PCIW,0.15,1193.0,Anita,3600,45,67,45,51,0,16,0.15279166666666666,1
MTURK,112a14c770ec5b7f907fd95b5c13c,3MQY1YVHS3SGWV38U0MAOKND3PS2B4,0.15,1193.0,Anita,3600,44,54,44,37,0,17,0.15225,1
MTURK,112a14c770ec5b7f907fd95b5c13c,3TCFMTM8HEWFJXLGS3TLI8A4HD112K,0.15,1190.0,Anita,3600,65,70,65,45,0,25,0.15291666666666667,1
MTURK,112a14c770ec5b7f907fd95b5c13c,304QEQWKZPSTJFP3JINIBGUXDQQO09,0.15,1190.0,Anita,3600,45,34,45,23,0,11,0.15141666666666667,1
MTURK,112a14c770ec5b7f907fd95b5c13c,3P0I4CQYVYFMR5QOCPG3IB31EV5OWB,0.15,1192.0,Anita,3600,50,45,50,33,0,12,0.15187499999999998,1
MTURK,112a14c770ec5b7f907fd95b5c13c,308KJXFUJRE5XKST716AUWCXLKJTAR,0.15,1186.0,Anita,3600,48,62,48,50,0,12,0.15258333333333332,1
MTURK,112a14c770ec5b7f907fd95b5c13c,3BVS8WK9Q03K7GHAJ372B0UUSLPBIO,0.15,1165.0,Anita,3600,94,260,90,203,4,57,0.16083333333333333,1
MTURK,112a14c770ec5b7f907fd95b5c13c,3AA88CN98PB7QJ09TY6YWR785YVKYM,0.15,1165.0,Anita,3600,75,236,71,183,4,53,0.15983333333333333,1
MTURK,112a14c770ec5b7f907fd95b5c13c,31SIZS5W59NK4LMIS8Y1KHQK1H8RQJ,0.15,1171.0,Anita,3600,51,56,51,21,0,35,0.15233333333333332,1
MTURK,112a14c770ec5b7f907fd95b5c13c,37VE3DA4YUPKBL6QDLPHBOTFS8ABHV,0.15,1163.0,Anita,3600,55,104,55,67,0,37,0.15433333333333332,1
MTURK,112a14c770ec5b7f907fd95b5c13c,3Z56AA6EK480XNQ68ROMSDFJVTXM6T,0.15,1161.0,Anita,3600,67,89,67,70,0,19,0.15370833333333334,1
MTURK,112a14c770ec5b7f907fd95b5c13c,3IKMEYR0LW3HPY720DZ3NN63QJ12KO,0.15,1161.0,Anita,3600,45,54,45,40,0,14,0.15225,1
MTURK,112a14c770ec5b7f907fd95b5c13c,3UQVX1UPFSPFC80YWKPL43RUCLV20I,0.15,1162.0,Anita,3600,45,47,45,35,0,12,0.15195833333333333,1
MTURK,112a14c770ec5b7f907fd95b5c13c,3QI9WAYOGQJ3VI3BSOK84MEPNIG6SQ,0.15,1152.0,Anita,3600,63,92,63,50,0,42,0.15383333333333332,1
MTURK,112a14c770ec5b7f907fd95b5c13c,36KM3FWE3RKMY9X42W6G0U82N1H703,0.15,1152.0,Anita,3600,76,106,76,63,0,43,0.15441666666666667,1
MTURK,112a14c770ec5b7f907fd95b5c13c,3W31J70BAS4UNGZ4X6O9Z0FP2AECK7,0.15,1152.0,Anita,3600,51,52,51,41,0,11,0.15216666666666667,1
MTURK,112a14c770ec5b7f907fd95b5c13c,3QGHA0EA0J828B1F8KBHCR327WMWBF,0.15,1143.0,Anita,3600,45,65,45,42,0,23,0.15270833333333333,1
MTURK,112a14c770ec5b7f907fd95b5c13c,30EV7DWJTV30R4FKRUCXM82Q43C6Y4,0.15,1143.0,Anita,3600,39,40,39,23,0,17,0.15166666666666667,1
MTURK,112a14c770ec5b7f907fd95b5c13c,3S8APUMBJXR0XPFKIV1H83H2CTXFB1,0.15,1140.0,Anita,3600,62,64,62,48,0,16,0.15266666666666667,1
MTURK,112a14c770ec5b7f907fd95b5c13c,3ROUCZ907F2EMWHML3PT1HQFBT6OOZ,0.15,1140.0,Anita,3600,42,30,42,22,0,8,0.15125,1
MTURK,112a14c770ec5b7f907fd95b5c13c,3EAWOID6MT5O9ZY0KU9W68O59JNV0I,0.15,1128.0,Anita,3600,48,42,48,32,0,10,0.15175,1
MTURK,112a14c770ec5b7f907fd95b5c13c,31MBOZ6PAOZ57MHMI60AE0S4RAJCLA,0.15,1135.0,Anita,3600,51,59,51,45,0,14,0.15245833333333333,1
MTURK,112a14c770ec5b7f907fd95b5c13c,3HKIF5DF6Y5NNWWIVVT3ZIMOP8U9GK,0.15,1133.0,Anita,3600,65,70,65,51,0,19,0.15291666666666667,1
MTURK,112a14c770ec5b7f907fd95b5c13c,34R3P23QHS9CZO418CLDY26029RWHV,0.15,1133.0,Anita,3600,44,40,44,29,0,11,0.15166666666666667,1
MTURK,112a14c770ec5b7f907fd95b5c13c,356TQKY9XF54GY27X0JVT9EK6ZS87Q,0.15,1133.0,Anita,3600,54,56,54,42,0,14,0.15233333333333332,1
MTURK,112a14c770ec5b7f907fd95b5c13c,31YWE12TE0KUVZ3F58VN98VDX81X7N,0.15,1133.0,Anita,3600,51,62,51,50,0,12,0.15258333333333332,1
MTURK,112a14c770ec5b7f907fd95b5c13c,3ZQA3IO31BZTQ4ALF1RIPLD7IIWO1C,0.15,1133.0,Anita,3600,48,68,48,54,0,14,0.15283333333333332,1
MTURK,112a14c770ec5b7f907fd95b5c13c,3IYI9285WS8ZCWTMFLOXYLFCNLECJ8,0.15,1127.0,Anita,3600,60,85,60,66,0,19,0.15354166666666666,1
MTURK,112a14c770ec5b7f907fd95b5c13c,3TZ0XG8CBUS8UHQ0CXHF755Q1PH984,0.15,1127.0,Anita,3600,41,47,41,37,0,10,0.15195833333333333,1
MTURK,112a14c770ec5b7f907fd95b5c13c,3URJ6VVYUPVAI3742JAKNJKAU274O6,0.15,1119.0,Anita,3600,46,51,46,34,0,17,0.15212499999999998,1
MTURK,112a14c770ec5b7f907fd95b5c13c,3QD8LUVX4X6F8VPWHFGQBOHH625X57,0.15,1119.0,Anita,3600,76,69,76,47,0,22,0.15287499999999998,1
MTURK,112a14c770ec5b7f907fd95b5c13c,3OWZNK3RYLXVSUCEUR35TAF1SAZ2UL,0.15,1119.0,Anita,3600,53,44,53,34,0,10,0.15183333333333332,1
MTURK,112a14c770ec5b7f907fd95b5c13c,3SMIWMMK61DH4AAL8BSCHHVQWHTWUW,0.15,1119.0,Anita,3600,69,55,69,44,0,11,0.15229166666666666,1
MTURK,112a14c770ec5b7f907fd95b5c13c,3P458N04Q1PN9Y69ZWESDHE5MSFX27,0.15,1119.0,Anita,3600,52,41,52,33,0,8,0.15170833333333333,1
MTURK,112a14c770ec5b7f907fd95b5c13c,3ATYLI1PRTA0LLQP5QXOTL9TCZWOJG,0.15,1118.0,Anita,3600,42,56,42,29,0,27,0.15233333333333332,1
MTURK,112a14c770ec5b7f907fd95b5c13c,3MNJFORX8BCY89YBHLA45HHA2XBF50,0.15,1110.0,Anita,3600,44,73,44,38,0,35,0.15304166666666666,1
MTURK,112a14c770ec5b7f907fd95b5c13c,3I01FDIL6MG9BS1S8WDGJABD6A42DB,0.15,1110.0,Anita,3600,48,63,48,39,0,24,0.15262499999999998,1
MTURK,112a14c770ec5b7f907fd95b5c13c,38EHZ67RIM02UGFCK4X844S8P70MGV,0.15,1110.0,Anita,3600,58,70,58,50,0,20,0.15291666666666667,1
MTURK,112a14c770ec5b7f907fd95b5c13c,3IV1AEQ4DRLX0T39Y98SWZJTXUS8JX,0.15,1110.0,Anita,3600,55,74,55,47,0,27,0.15308333333333332,1
MTURK,112a14c770ec5b7f907fd95b5c13c,3ZURAPD288VZKRXSGY8S2R4TQH6F1I,0.15,1110.0,Anita,3600,44,67,44,34,0,33,0.15279166666666666,1
MTURK,112a14c770ec5b7f907fd95b5c13c,3WYZV0QBFJLHXB65IP73EAH9GYTBXO,0.15,1106.0,Anita,3600,45,63,45,39,0,24,0.15262499999999998,1
MTURK,112a14c770ec5b7f907fd95b5c13c,3G5RUKN2ECBTXOD4IZ6YP2VLQKG9NS,0.15,1109.0,Anita,3600,47,67,47,39,0,28,0.15279166666666666,1
MTURK,112a14c770ec5b7f907fd95b5c13c,3JTPR5MTZSK9OVQPIW11LU9FATS5KS,0.15,1102.0,Anita,3600,48,64,48,41,0,23,0.15266666666666667,1
MTURK,112a14c770ec5b7f907fd95b5c13c,31GN6YMHLP01PXIHJ6XC2GD2BK8WSG,0.15,1091.0,Anita,3600,67,66,67,55,0,11,0.15275,1
MTURK,112a14c770ec5b7f907fd95b5c13c,3XEIP58NL0VIFFSWAKKIPYTP0S4ZLV,0.15,1091.0,Anita,3600,48,53,48,45,0,8,0.15220833333333333,1
MTURK,112a14c770ec5b7f907fd95b5c13c,3R868ACW4SK2TNEVZTN2C6OH4BIZGP,0.15,1092.0,Anita,3600,62,49,62,38,0,11,0.15204166666666666,1
MTURK,112a14c770ec5b7f907fd95b5c13c,3HO4MYYR12WJAVVFHTF8JNWD8F16U6,0.15,1092.0,Anita,3600,45,37,45,28,0,9,0.15154166666666666,1
MTURK,112a14c770ec5b7f907fd95b5c13c,36D1BWBEHN9CFM75LPCJ20Y7FOVM2C,0.15,1094.0,Anita,3600,50,54,50,45,0,9,0.15225,1
MTURK,112a14c770ec5b7f907fd95b5c13c,335VBRURDJ8P3I0RP03FZF1CCSF9E3,0.15,1102.0,Anita,3600,65,59,65,49,0,10,0.15245833333333333,1
MTURK,112a14c770ec5b7f907fd95b5c13c,3ZUE82NE0A9HVRHDFJH7H1R14NCF82,0.15,1102.0,Anita,3600,45,37,45,31,0,6,0.15154166666666666,1
MTURK,112a14c770ec5b7f907fd95b5c13c,3V7ICJJAZAOQZ9IVYE5YHZKBN3O4B2,0.15,1090.0,Anita,3600,64,86,64,71,0,15,0.15358333333333332,1
MTURK,112a14c770ec5b7f907fd95b5c13c,3TY2U1TEB7IMKAZSPD5JLPS7D5MJJS,0.15,1093.0,Anita,3600,88,100,88,78,0,22,0.15416666666666667,1
MTURK,112a14c770ec5b7f907fd95b5c13c,3I7SHAD35M4J1N4BR1TEYRFFQ4I7ME,0.15,1093.0,Anita,3600,67,43,67,31,0,12,0.15179166666666666,1
MTURK,112a14c770ec5b7f907fd95b5c13c,322ZSN9Z5GSQVVCCY0WJHTQXTAO4TS,0.15,1083.0,Anita,3600,45,51,45,42,0,9,0.15212499999999998,1
MTURK,112a14c770ec5b7f907fd95b5c13c,3L1EFR8WWTDH9W0NKBNLHXMCOTU9FL,0.15,1083.0,Anita,3600,47,67,47,49,0,18,0.15279166666666666,1
MTURK,112a14c770ec5b7f907fd95b5c13c,366FYU4PTGX9KEJITXU4POFSNMREK2,0.15,1089.0,Anita,3600,88,80,88,59,0,21,0.15333333333333332,1
MTURK,112a14c770ec5b7f907fd95b5c13c,3AJA9FLWSC6AKXTQO5TYUQLF7JGIFC,0.15,1076.0,Anita,3600,11399,72939,10312,19351,1087,53588,3.1891249999999998,0
MTURK,112a14c770ec5b7f907fd95b5c13c,3YKP7CX6G2NNIW0E0C35KB4LE5E7BP,0.15,1089.0,Anita,3600,23,32,23,19,0,13,0.15133333333333332,1
MTURK,112a14c770ec5b7f907fd95b5c13c,337F8MIIMZLPFMFL0Y89XIOSWZR40G,0.15,1079.0,Anita,3600,47,66,47,37,0,29,0.15275,1
MTURK,112a14c770ec5b7f907fd95b5c13c,3LEG2HW4UFV69CFOZ2867AEYINK2FM,0.15,1080.0,Anita,3600,49,62,49,21,0,41,0.15258333333333332,1
MTURK,112a14c770ec5b7f907fd95b5c13c,3OID399FXGFTCMD4WRSN3T52FE9FD8,0.15,1081.0,Anita,3600,44,60,44,32,0,28,0.1525,1
MTURK,112a14c770ec5b7f907fd95b5c13c,3EFNPKWBMSW4XQWH0K3QNDWMIZV30U,0.15,1081.0,Anita,3600,49,70,49,50,0,20,0.15291666666666667,1
MTURK,112a14c770ec5b7f907fd95b5c13c,3909MD9T2ZPY4SR4SM379BNNFQAFE1,0.15,1057.0,Anita,3600,58,94,58,37,0,57,0.15391666666666667,1
MTURK,112a14c770ec5b7f907fd95b5c13c,3D7VY91L65563Z714I5U3T1B9U8MBE,0.15,1063.0,Anita,3600,91,107,91,46,0,61,0.15445833333333334,1
MTURK,112a14c770ec5b7f907fd95b5c13c,3ZICQFRS31Q2K490PLBRXD4NF1CZZE,0.15,1063.0,Anita,3600,63,38,63,25,0,13,0.15158333333333332,1
MTURK,112a14c770ec5b7f907fd95b5c13c,3CMIQF80GNYRI2OY0KV39MZO5UV6Q1,0.15,1053.0,Anita,3600,64,77,64,48,0,29,0.15320833333333334,1
MTURK,112a14c770ec5b7f907fd95b5c13c,3LAZVA75NIZ0FPSHY5RWU4NCAOB2O8,0.15,1053.0,Anita,3600,47,61,47,36,0,25,0.15254166666666666,1
MTURK,112a14c770ec5b7f907fd95b5c13c,309D674SHZTTUDVARTBG0XWZFG5CBN,0.15,1064.0,Anita,3600,38,49,38,22,0,27,0.15204166666666666,1
MTURK,112a14c770ec5b7f907fd95b5c13c,3ZLW647WAL3BT0ZVF77461P1FXF32E,0.15,1062.0,Anita,3600,46,60,46,23,0,37,0.1525,1
MTURK,112a14c770ec5b7f907fd95b5c13c,32W3UF2EZOT99EA1CE1TSJQT5OOC4H,0.15,1059.0,Anita,3600,43,63,43,43,0,20,0.15262499999999998,1
MTURK,f7894afaa9c87d30f7b8a102e92479d,30U1YOGZGB5VE2RB18DBPUA9QENDSK,3.0,16.0,MED Lab,3600,107,600,17,11,90,589,3.5,1
MTURK,f7894afaa9c87d30f7b8a102e92479d,3JMNNNO3B243JTQV8XU134ANTKRW2A,2.0,1.0,HCI Lab,7200,88,564,12,10,76,554,2.1566666666666667,1
MTURK,f7894afaa9c87d30f7b8a102e92479d,3EGKVCRQFW7B5SBARFF9KMN675PYB8,0.3,22.0,sustyyl,3600,46,40,29,10,17,30,0.30333333333333334,0
MTURK,f7894afaa9c87d30f7b8a102e92479d,3SNR5F7R91SP0ISPZ4MI4S5N5F1EI6,0.5,1.0,Cihan Cobanoglu,3600,32,30,21,6,11,24,0.5041666666666667,0
MTURK,f7894afaa9c87d30f7b8a102e92479d,35YHTYFL1GBWBAJSAUJOXIQOFLJFVZ,1.0,12.0,Tamar,3600,26,36,11,18,15,18,1.01,0
MTURK,5ba2c2bc7b3bb19711ede5857611abc,32K26U12EQJRBNVGLZLJJPAIIXDVD3,0.02,61.0,Wyatt Lee,180,44,79,36,57,8,22,0.028777777777777777,1
MTURK,5ba2c2bc7b3bb19711ede5857611abc,30UZJB2POHJ7MUD2Z4OFT1CRYQ8530,0.2,0.0,Edward Gibson,3600,19,60,17,46,2,14,0.20333333333333334,1
MTURK,5ba2c2bc7b3bb19711ede5857611abc,3VEI3XUCZRBK9D2N6BAP1I72OEURPZ,0.5,0.0,Pelin Constantin,3600,22,90,13,59,9,31,0.5125,1
MTURK,5ba2c2bc7b3bb19711ede5857611abc,3XJOUITW8U5IP4GUADU912YUHVDTQ5,0.5,0.0,Pelin Constantin,3600,41,149,24,105,17,44,0.5206944444444445,1
MTURK,5ba2c2bc7b3bb19711ede5857611abc,3L60IFZKF3WF72QWRTQQE535FEMHHN,0.5,0.0,Pelin Constantin,3600,186,899,94,648,92,251,0.6248611111111111,1
MTURK,5ba2c2bc7b3bb19711ede5857611abc,37AQKJ12TX2VHK8MRHO4679H12CTTJ,0.5,0.0,Pelin Constantin,3600,30,90,10,43,20,47,0.5125,1
MTURK,5ba2c2bc7b3bb19711ede5857611abc,3IQ9O0AYW6D586SBX5P0S078QLWTI2,0.5,0.0,Pelin Constantin,3600,18,39,13,14,5,25,0.5054166666666666,1
MTURK,5ba2c2bc7b3bb19711ede5857611abc,35JDMRECC5SHS0NQU5X2I7CRP94EGA,2.0,1.0,Mia Park,3600,450,2369,4,250,446,2119,3.316111111111111,1
MTURK,5ba2c2bc7b3bb19711ede5857611abc,31D0ZWOD0AZQXMICRNUUOR65CJHA0E,0.15,0.0,Hugh Stephens,600,8,599,2,224,6,375,0.29974999999999996,1
MTURK,5ba2c2bc7b3bb19711ede5857611abc,309D674SHZLFAOIK9HNAE3SC3QZBC3,0.15,0.0,Hugh Stephens,600,31,30,18,22,13,8,0.1575,1
MTURK,5ba2c2bc7b3bb19711ede5857611abc,3S4TINXCC0I17SYM13BVFQZVKOGBOU,0.5,0.0,Lalin Anik,900,32,300,25,287,7,13,0.6666666666666666,1
MTURK,5ba2c2bc7b3bb19711ede5857611abc,3KVQ0UJWPXLMZ67GPYWYNBZNLAVW5W,0.15,0.0,Hugh Stephens,600,47,299,37,283,10,16,0.22475,1
MTURK,5ba2c2bc7b3bb19711ede5857611abc,3538U0YQ1FU5GJX6RYIYHR1KWSYF37,3.0,0.0,jeff cremer,1800,23,750,9,742,14,8,4.25,1
MTURK,5ba2c2bc7b3bb19711ede5857611abc,3DIIW4IV8PV281UYZGXY7T8W0CPI43,0.5,3.0,Lisa Catarineau,86400,98,2280,48,1891,50,389,0.5131944444444444,0
MTURK,5ba2c2bc7b3bb19711ede5857611abc,3P4ZBJFX2V3U7CBS8EXWZOEV4DWWFC,0.5,3.0,Lisa Catarineau,86400,145,2580,64,1920,81,660,0.5149305555555556,0
MTURK,5ba2c2bc7b3bb19711ede5857611abc,368IUKXGA5884ALGVZGXDOTMIHQP67,0.5,3.0,Lisa Catarineau,86400,202,2850,82,1947,120,903,0.5164930555555556,0
MTURK,5ba2c2bc7b3bb19711ede5857611abc,35A1YQPVFEGK4KYYDLG8CLEA08KI58,0.5,0.0,Lisa Catarineau,86400,1109,10650,126,2344,983,8306,0.5616319444444444,0
MTURK,5ba2c2bc7b3bb19711ede5857611abc,3MD8CKRQZZN54IG2SAEBRNY655YRJ7,0.5,0.0,Lisa Catarineau,86400,1145,10680,154,2343,991,8337,0.5618055555555556,0
MTURK,5ba2c2bc7b3bb19711ede5857611abc,3M67TQBQQHOM0P4D5C57ER7APN79AH,2.5,0.0,StanfordPragLab,3600,66,119,28,84,38,35,2.582638888888889,0
MTURK,5ba2c2bc7b3bb19711ede5857611abc,38Z7YZ2SC7E2VRUY13ESNASOIUYIQW,2.1,0.0,Shopping Study,3600,154,2099,52,1341,102,758,3.324416666666667,1
MTURK,5ba2c2bc7b3bb19711ede5857611abc,3ATYLI1PRVPC4UXRAQR71Y0HJWCOJI,6.0,1.0,Samantha Rundle,18000,1675,15180,187,2486,1488,12694,11.059999999999999,1
MTURK,5ba2c2bc7b3bb19711ede5857611abc,3MDWE879VLE79XG0AY1TMNZU63J9B8,0.25,0.0,utabusiness456,1800,7,239,3,10,4,229,0.2831944444444444,1
MTURK,5ba2c2bc7b3bb19711ede5857611abc,3BFNCI9LYJPLE2Y8VX585CRAK7973V,1.0,0.0,Melanie B Brewer,600,2,239,2,239,0,0,1.3983333333333334,1
MTURK,5ba2c2bc7b3bb19711ede5857611abc,3QD8LUVX503XYN9EUP5QPT48WYS5XX,1.0,0.0,SeomgyunLee,3600,763,3630,72,259,691,3371,2.0083333333333333,1
MTURK,5ba2c2bc7b3bb19711ede5857611abc,379OL9DBTVGYTJU2TCJMGNIX3T8Y91,0.2,0.0,31May Prod,60,2,59,2,59,0,0,0.3966666666666667,1
MTURK,5ba2c2bc7b3bb19711ede5857611abc,3W0XM68YZPBTSNFK1SUN4ZN9QZGK1O,2.0,0.0,Colala - the computation and language lab,3600,116,1980,5,353,111,1627,3.1,1
MTURK,5ba2c2bc7b3bb19711ede5857611abc,3FK4G712NXBGA73JNT7J9ZSFJYXSS1,2.0,0.0,TTU Language and Social Interaction Lab,7200,507,7200,68,947,439,6253,4.0,1
MTURK,5ba2c2bc7b3bb19711ede5857611abc,3E9ZFLPWOYHFF4HAP0EX9ASWGQSXIU,3.0,0.0,Shaojin Ding,3600,46,1109,13,384,33,725,3.924166666666667,1
MTURK,5ba2c2bc7b3bb19711ede5857611abc,3XJOUITW8UY1EXUUYBI99PBGOLHQTO,2.5,0.0,Edward Gibson,7200,217,6449,15,903,202,5546,4.739236111111111,1
MTURK,5ba2c2bc7b3bb19711ede5857611abc,31GECDVA9JMKOVSO3ZTZHNEAT4I66S,0.15,0.0,Hugh Stephens,600,4,270,4,269,0,1,0.2175,1
MTURK,5ba2c2bc7b3bb19711ede5857611abc,356ZPKYPUHHUHLKZOEN06EPKNJ0YPP,0.15,0.0,Hugh Stephens,600,4,240,4,210,0,30,0.21,1
MTURK,5ba2c2bc7b3bb19711ede5857611abc,37SOB9Z0TWHXCNF7R1AIDV3L7MH3LN,0.5,0.0,Harrison,5400,10,4889,8,360,2,4529,0.9526851851851852,1
MTURK,5ba2c2bc7b3bb19711ede5857611abc,3NKW03WTLM7BSSQE9QK1LMUEH7NQWA,0.15,0.0,Hugh Stephens,600,3,300,3,300,0,0,0.22499999999999998,1
MTURK,5ba2c2bc7b3bb19711ede5857611abc,3XJOUITW8UX2W87B00M418SJ272QT2,0.0,1.0,Nina Xue,1800,4,1739,4,300,0,1439,0.0,1
MTURK,5ba2c2bc7b3bb19711ede5857611abc,306996CF6W9X2VIBCX19SEKIGLU1BY,3.0,0.0,Shaojin Ding,3600,96,779,5,147,91,632,3.649166666666667,1
MTURK,5ba2c2bc7b3bb19711ede5857611abc,38LRF35D5NOSBHFUD8I61AN7F9AU35,5.0,1.0,Strunk Lab,21600,4,30,2,28,2,2,5.006944444444445,1
MTURK,5ba2c2bc7b3bb19711ede5857611abc,3T8DUCXY0N6BYCBC98CBMSTCGCB9TI,0.52,1.0,Yale Cognition & Development Lab,3000,7,60,2,49,5,11,0.5304,1
MTURK,5ba2c2bc7b3bb19711ede5857611abc,3AFT28WXLFRSLV3IO9R1QX134MOOIH,3.5,0.0,Shaojin Ding,3600,5,89,2,38,3,51,3.586527777777778,1
MTURK,5ba2c2bc7b3bb19711ede5857611abc,3YKP7CX6H6R3VES7V1398R8OBDW7BV,0.25,0.0,utabusiness456,1800,82,449,2,93,80,356,0.3123611111111111,1
MTURK,5ba2c2bc7b3bb19711ede5857611abc,3566S7OX5DJ8L95WG3MAS5NPG4N17P,0.15,0.0,Hugh Stephens,600,87,389,20,4,67,385,0.24725,1
MTURK,5ba2c2bc7b3bb19711ede5857611abc,3MJ28H2Y1E8EUXYEYC5O6HM1I925O1,0.15,0.0,Hugh Stephens,600,100,390,20,103,80,287,0.2475,1
MTURK,5ba2c2bc7b3bb19711ede5857611abc,3URJ6VVYVTAFQWF0FPX5H9SS6PGO4D,0.85,0.0,Aravinth,600,2,599,2,599,0,0,1.6985833333333331,1
MTURK,5ba2c2bc7b3bb19711ede5857611abc,3P4ZBJFX2V3E1305VA979NQ0A52WFA,0.15,0.0,Hugh Stephens,600,41,270,27,214,14,56,0.2175,1
MTURK,5ba2c2bc7b3bb19711ede5857611abc,3PUOXASB5737KOKBF01T8GUT18YZ9P,0.65,0.0,Yale Cognition & Development Lab,3000,158,1049,35,158,123,891,0.8772833333333334,1
MTURK,5ba2c2bc7b3bb19711ede5857611abc,3UYRNV2KITZDPUNI7KKLDXS97O8N87,0.65,0.0,Yale Cognition & Development Lab,3000,158,1049,35,158,123,891,0.8772833333333334,1
MTURK,5ba2c2bc7b3bb19711ede5857611abc,3N5YJ55YXG3R8IGX4I4Z9OY4XC8NAB,0.65,0.0,Yale Cognition & Development Lab,3000,158,1049,35,158,123,891,0.8772833333333334,1
MTURK,5ba2c2bc7b3bb19711ede5857611abc,38O9DZ0A62NXLIAEF3OQJRLQZ9J26W,2.5,0.0,Makoto Kato,3600,754,2850,3,7,751,2843,4.479166666666667,1
MTURK,5ba2c2bc7b3bb19711ede5857611abc,3X55NP42EP8654B4J4O5W6BWB5SP3K,1.0,0.0,Alexandria (University of Queensland),172800,603,2339,3,3,600,2336,1.0135358796296297,1
MTURK,5ba2c2bc7b3bb19711ede5857611abc,3LN3BXKGD32LXSUQ0Z4ZV02YXJPGWB,4.2,0.0,Michael Jurgensson,14400,632,768,53,131,579,637,4.424,0
MTURK,5ba2c2bc7b3bb19711ede5857611abc,341H3G5YF0ERYUQK3FAT5KXEL5OZ06,0.15,0.0,Hugh Stephens,600,57,78,29,55,28,23,0.16949999999999998,1
MTURK,5ba2c2bc7b3bb19711ede5857611abc,30Y6N4AHYPE2O2N1LCYK3SYAS9ADR5,3.0,0.0,Ron Walters,3600,903,1364,42,55,861,1309,4.136666666666667,1
MTURK,5ba2c2bc7b3bb19711ede5857611abc,3X4Q1O9UBIUQ9M2QKWSDX0K3AH1O7H,1.2,0.0,Min-Hsuan Tu,7200,870,1170,18,51,852,1119,1.395,1
MTURK,5ba2c2bc7b3bb19711ede5857611abc,3CZH926SIBDUWYWFFNYBLWSFEYYE4N,0.6,0.0,anne hamby,1800,402,570,7,46,395,524,0.79,1
MTURK,5ba2c2bc7b3bb19711ede5857611abc,39N6W9XWRDN0XB91CD0DDXJYG24GYE,0.25,0.0,SurveyComet,1800,11,359,9,14,2,345,0.29986111111111113,1
MTURK,5ba2c2bc7b3bb19711ede5857611abc,3UXQ63NLAAMK6VURDCJ9IEQ5RA8BL0,0.25,0.0,SurveyComet,1800,11,389,9,14,2,375,0.3040277777777778,1
MTURK,5ba2c2bc7b3bb19711ede5857611abc,3B9XR6P1WEVEB56RAR7W2ZDDNL3BJY,0.25,0.0,SurveyComet,1800,9,389,7,14,2,375,0.3040277777777778,1
MTURK,5ba2c2bc7b3bb19711ede5857611abc,3PEG1BH7AER9MPC9SC783EDQ2A3BKX,0.25,0.0,SurveyComet,1800,12,419,10,14,2,405,0.30819444444444444,1
MTURK,5ba2c2bc7b3bb19711ede5857611abc,3ZQA3IO31BRRZIFWO76C4JHQ03MO1B,0.25,0.0,SurveyComet,1800,12,419,10,14,2,405,0.30819444444444444,1
MTURK,5ba2c2bc7b3bb19711ede5857611abc,3G3AJKPCYPEKXNK9EIUJBMDLGRZY4V,0.5,0.0,Marc,300,53,210,2,35,51,175,0.8500000000000001,1
MTURK,5ba2c2bc7b3bb19711ede5857611abc,3UL5XDRDNC8DOFLNA8JB427YKW258B,3.5,0.0,Shaojin Ding,3600,1222,1889,49,700,1173,1189,5.3365277777777775,0
MTURK,5ba2c2bc7b3bb19711ede5857611abc,34HEO7RUG7CQL72VEHCAOBZ1X7BARR,2.5,0.0,sonya mishra,5700,1185,2999,79,2114,1106,885,3.8153508771929827,0
MTURK,5ba2c2bc7b3bb19711ede5857611abc,3D3B8GE891QZB9A5E3VYU0SVX1MP9K,0.0,1.0,Sam Gilbert,3600,530,899,34,46,496,853,0.0,0
MTURK,5ba2c2bc7b3bb19711ede5857611abc,3R5OYNIC2C4JOE44GPFV4KA704HTPW,0.8,0.0,Lalin Anik,900,9,239,2,9,7,230,1.0124444444444445,1
MTURK,5ba2c2bc7b3bb19711ede5857611abc,386T3MLZLN67XPR7S0MP0LKJ65A08F,4.0,0.0,remesh,7200,70,960,22,933,48,27,4.533333333333333,0
MTURK,5ba2c2bc7b3bb19711ede5857611abc,3UQ1LLR26AQTNXPCWIAMRFH51FZLAY,3.0,0.0,Ron Walters,3600,55,749,5,195,50,554,3.6241666666666665,1
MTURK,5ba2c2bc7b3bb19711ede5857611abc,3V0TR1NRVAXQ2US097ZOMWNBMKQ4A3,1.1,0.0,Maze,7200,151,629,38,490,113,139,1.1960972222222224,1
MTURK,5ba2c2bc7b3bb19711ede5857611abc,30IRMPJWDZJK9TBXXRQY21AOQPOKRN,0.15,0.0,Hugh Stephens,600,147,239,36,130,111,109,0.20975,1
MTURK,5ba2c2bc7b3bb19711ede5857611abc,3HUR21WDDUY8X9NB031HOKZ3AW1XY0,0.01,0.0,Amazon Requester Inc. - Retail Business Services,300,2,30,2,30,0,0,0.011,1
MTURK,5ba2c2bc7b3bb19711ede5857611abc,386T3MLZLMUT3KJ82Y1BPLC9SWR08A,0.6,0.0,Stanford GSB Behavioral Lab,1800,36,1050,2,0,34,1050,0.95,1
MTURK,5ba2c2bc7b3bb19711ede5857611abc,30ZKOOGW2W6RJZ4LMC5OUDD73NRA1B,2.5,0.0,Makoto Kato,3600,36,1379,3,1,33,1378,3.457638888888889,1
MTURK,5ba2c2bc7b3bb19711ede5857611abc,3Z3R5YC0P3NM9MWB054WM3J16FYTF3,0.15,0.0,Hugh Stephens,600,58,60,18,19,40,41,0.16499999999999998,1
MTURK,5ba2c2bc7b3bb19711ede5857611abc,3HA5ODM5K9RTIV1A7PVANK76PPJVSE,7.5,0.0,Larry Rudman,604800,6180,36267,279,6138,5901,30129,7.949739583333334,1
MTURK,5ba2c2bc7b3bb19711ede5857611abc,3KL228NDMVHCQNU6GZEEPZNAH2OKGI,1.1,0.0,Maze,7200,193,540,57,181,136,359,1.1825,1
MTURK,5ba2c2bc7b3bb19711ede5857611abc,3P6ENY9P79WS77P7S1WSC91B5L9IH3,0.3,8.0,SurveyComet,1800,18,60,14,50,4,10,0.31,1
MTURK,5ba2c2bc7b3bb19711ede5857611abc,35NNO802AVWKH3BIVZR5HTY7RXINIH,0.3,8.0,SurveyComet,1800,18,60,14,50,4,10,0.31,1
MTURK,5ba2c2bc7b3bb19711ede5857611abc,3X0EMNLXEPPP6U7VAL3G07TWZEFPVC,0.3,8.0,SurveyComet,1800,20,60,16,50,4,10,0.31,1
MTURK,5ba2c2bc7b3bb19711ede5857611abc,3JMNNNO3B146TC6UYXX0QW4HVDQ2WD,0.3,8.0,SurveyComet,1800,18,60,14,50,4,10,0.31,1
MTURK,5ba2c2bc7b3bb19711ede5857611abc,31ODACBENUFUEER6G3D0PPZZ567SQ1,0.3,8.0,SurveyComet,1800,18,60,14,50,4,10,0.31,1
MTURK,5ba2c2bc7b3bb19711ede5857611abc,3OWZNK3RYLPT18HP3XIZ88JKAXF2UE,0.3,8.0,SurveyComet,1800,12,30,12,29,0,1,0.305,1
MTURK,5ba2c2bc7b3bb19711ede5857611abc,3DQYSJDTYLBDDSN01MONUGRD1ILXE2,0.2,112.0,SurveyComet,1800,14,30,14,29,0,1,0.20333333333333334,1
MTURK,5ba2c2bc7b3bb19711ede5857611abc,3P458N04Q1HLICBK82TMSFIO4FW2X6,0.2,112.0,SurveyComet,1800,14,30,14,29,0,1,0.20333333333333334,1
MTURK,5ba2c2bc7b3bb19711ede5857611abc,388CL5C1RJNUX8XDD4T54PT3MP3LHK,0.2,112.0,SurveyComet,1800,14,30,14,29,0,1,0.20333333333333334,1
MTURK,5ba2c2bc7b3bb19711ede5857611abc,3U74KRR67MLAQHRTPBQ9V00G2EYNTY,0.2,112.0,SurveyComet,1800,14,30,14,29,0,1,0.20333333333333334,1
MTURK,5ba2c2bc7b3bb19711ede5857611abc,3BFF0DJK8XC76UJYX77VUUAMPD6STF,0.2,112.0,SurveyComet,1800,14,30,14,29,0,1,0.20333333333333334,1
MTURK,5ba2c2bc7b3bb19711ede5857611abc,3SSN80MU8COGZSFAX8ZQSB4ILFHXKM,0.2,112.0,SurveyComet,1800,14,30,14,29,0,1,0.20333333333333334,1
MTURK,5ba2c2bc7b3bb19711ede5857611abc,30UZJB2POHC11BNT6WOWJ6WWHUM358,0.2,112.0,SurveyComet,1800,14,30,14,29,0,1,0.20333333333333334,1
MTURK,5ba2c2bc7b3bb19711ede5857611abc,3JY0Q5X05J6OIH60RPB7554OH0SGGI,0.15,0.0,Hugh Stephens,600,52,90,25,11,27,79,0.1725,1
MTURK,5ba2c2bc7b3bb19711ede5857611abc,38DCH97KHHWL3UGZD2S9LQVVOE8QJD,0.17,0.0,Maarten Sap,10800,130,360,2,3,128,357,0.17566666666666667,1
MTURK,5ba2c2bc7b3bb19711ede5857611abc,35U0MRQMUJEP1XZTRNS4GOOM37DOV0,3.5,0.0,Berkeley Neuroecon Lab,2700,103,1620,44,368,59,1252,5.6,1
MTURK,5ba2c2bc7b3bb19711ede5857611abc,34XASH8KLQMUN4VL5BZPCJ2DEDTPM5,0.15,0.0,Hugh Stephens,600,42,60,24,47,18,13,0.16499999999999998,1
MTURK,5ba2c2bc7b3bb19711ede5857611abc,39N6W9XWSH7A2VU43IXN2YC5JUKGYA,3.0,1.0,University of Rochester,7200,58,1230,17,322,41,908,3.5125,1
MTURK,5ba2c2bc7b3bb19711ede5857611abc,3EKZL9T8Y8MP11L699X60EVAY8HCH7,0.15,0.0,Hugh Stephens,600,2,600,2,600,0,0,0.3,1
MTURK,5ba2c2bc7b3bb19711ede5857611abc,3B9J25CZ391FKRDP3RUDGTJ4HE0SCV,0.5,1.0,Debbie Martinez,7200,542,4410,39,442,503,3968,0.80625,1
MTURK,5ba2c2bc7b3bb19711ede5857611abc,3YZ7A3YHR5UQ97VSV5E4MK5XYBJ5SJ,1.5,0.0,ETH DeSciL,1800,138,990,25,180,113,810,2.325,1
MTURK,5ba2c2bc7b3bb19711ede5857611abc,34KYK9TV3VWWAMLJPRYI59DMZT0SBO,0.5,1.0,Debbie Martinez,7200,454,4110,36,353,418,3757,0.7854166666666667,1
MTURK,5ba2c2bc7b3bb19711ede5857611abc,356TQKY9YJK0EPUA524IDVAYUX7876,0.1,1241.0,Peter Ciuffetti,240,49,180,2,21,47,159,0.17500000000000002,1
MTURK,5ba2c2bc7b3bb19711ede5857611abc,378G7J1SJM3W19MP7NVHT6GY20UWEA,3.6,0.0,Angela,7200,14,210,2,79,12,131,3.705,1
MTURK,5ba2c2bc7b3bb19711ede5857611abc,3D06DR5227B8VSGQCNIM51HZ44TAMX,1.0,0.0,Yu Research Group,5400,2,150,2,150,0,0,1.0277777777777777,1
MTURK,5ba2c2bc7b3bb19711ede5857611abc,3INZSNUD8ZPNG93CJ2VK4OR36S5D9U,0.36,0.0,Stanford GSB Behavioral Lab,1200,147,750,3,1,144,749,0.585,1
MTURK,5ba2c2bc7b3bb19711ede5857611abc,3PN6H8C9R5QEYZY9A2F9I88A36VAD7,1.0,1.0,apollo,1800,151,720,6,70,145,650,1.4,1
MTURK,5ba2c2bc7b3bb19711ede5857611abc,3S8APUMBJXC0KFEX0K12Y0S37D8FBN,0.35,0.0,Carlina,2700,30,240,6,69,24,171,0.38111111111111107,1
MTURK,5ba2c2bc7b3bb19711ede5857611abc,3KQC8JMJHFT2PMWG2HURCAGOMZ33HN,0.5,0.0,Online Research Studies,3600,409,1470,9,88,400,1382,0.7041666666666666,1
MTURK,5ba2c2bc7b3bb19711ede5857611abc,3RWO3EJEMKMS4IRYJE44U5KGF501P6,0.25,1.0,UPenn Researcher,1800,3,30,3,30,0,0,0.25416666666666665,1
MTURK,5ba2c2bc7b3bb19711ede5857611abc,3O0M2G5VC8PJUPA05ULLY6G972E94H,2.5,1.0,Samantha Rundle,3600,528,2159,10,72,518,2087,3.999305555555556,1
MTURK,5ba2c2bc7b3bb19711ede5857611abc,3XEIP58NL02Z88UI2VC0YJWHL9ELZC,1.0,1.0,Yale Institute for Network Science,5400,5,30,2,8,3,22,1.0055555555555555,1
MTURK,5ba2c2bc7b3bb19711ede5857611abc,3QI9WAYOHUNJ80V4NDKCS2ISKTN6SR,0.25,0.0,utabusiness456,3600,43,840,2,2,41,838,0.30833333333333335,1
MTURK,5ba2c2bc7b3bb19711ede5857611abc,39O6Z4JLX28D5RTV35M61DR2RBBXVT,4.0,0.0,remesh,7200,926,2250,5,33,921,2217,5.25,1
MTURK,5ba2c2bc7b3bb19711ede5857611abc,3E9ZFLPWOZS96QC9E5MEGKD4A8UIX1,1.2,1.0,Eric Bogert,600,93,570,2,32,91,538,2.34,1
MTURK,5ba2c2bc7b3bb19711ede5857611abc,3FI30CQHVKJQU79JZQA7S30279GB6D,0.15,0.0,Hugh Stephens,600,42,90,32,52,10,38,0.1725,1
MTURK,5ba2c2bc7b3bb19711ede5857611abc,3PKVGQTFIH4CLX2AVUA7C34ZGUVRYM,0.15,1.0,Pix,3600,49,48,31,17,18,31,0.152,1
MTURK,5ba2c2bc7b3bb19711ede5857611abc,36D1BWBEIR1JRI06CCVP976FXI72MT,5.0,1.0,Joseph MacDonald,7200,22,30,2,6,20,24,5.020833333333333,1
MTURK,5ba2c2bc7b3bb19711ede5857611abc,388CL5C1RJU7ZUPLWW16G2UPDSFLHW,0.65,1.0,Aner Sela,600,2,60,2,60,0,0,0.7150000000000001,1
MTURK,5ba2c2bc7b3bb19711ede5857611abc,307FVKVSZUSKQBKHAATPSH0YRVA47L,0.5,1.0,UPenn Researcher,3600,47,1290,2,1179,45,111,0.6791666666666667,1
MTURK,5ba2c2bc7b3bb19711ede5857611abc,38Z7YZ2SB21AGJ0KSI7HHGX58Y3QIJ,0.36,108.0,Stanford GSB Behavioral Lab,1200,2,810,2,810,0,0,0.603,1
MTURK,5ba2c2bc7b3bb19711ede5857611abc,307FVKVSYRFLFAXKKMQ3BOBEFMW47S,2.0,1.0,SoCoGo,3600,73,240,3,75,70,165,2.1333333333333333,1
MTURK,5ba2c2bc7b3bb19711ede5857611abc,32K26U12DMNLDGGFM30GW6G0XLBVDH,0.6,0.0,Stanford GSB Behavioral Lab,1800,374,1320,5,60,369,1260,1.04,1
MTURK,5ba2c2bc7b3bb19711ede5857611abc,32PT7WK7EQRE9SP47LRPQ0K89ZBD3Y,0.25,0.0,utabusiness456,1800,2,30,2,30,0,0,0.25416666666666665,1
MTURK,5ba2c2bc7b3bb19711ede5857611abc,3QQUBC64ZEJHWBKAFYEM5N5VT73XNZ,3.75,0.0,Research Methods,7200,222,2850,14,428,208,2422,5.234375,1
MTURK,5ba2c2bc7b3bb19711ede5857611abc,3L1EFR8WWS4KETH8A8QASOUOI6A9FS,1.8,0.0,Stanford GSB Behavioral Lab,3600,191,2250,11,346,180,1904,2.925,1
MTURK,5ba2c2bc7b3bb19711ede5857611abc,33KGGVH24TGJPA5Y6PH3JPCCOZI1X2,0.5,0.0,Stanford GSB Behavioral Lab,1800,95,1530,6,196,89,1334,0.925,1
MTURK,5ba2c2bc7b3bb19711ede5857611abc,32LAQ1JNUDABD6X8RNAQJL93MEPTUQ,0.25,275.0,ALPS,1800,6,60,2,46,4,14,0.25833333333333336,1
MTURK,5ba2c2bc7b3bb19711ede5857611abc,36BTXXLZ3YEXE7NV1ZZZ5HQ1TD44R8,0.5,1.0,ASI Mechanical Turk,3600,2,150,2,150,0,0,0.5208333333333334,1
MTURK,5ba2c2bc7b3bb19711ede5857611abc,3JVP4ZJHDP6WT18YVCK3JDH03WE0I8,2.0,0.0,CAH,3600,13,3540,11,1049,2,2491,3.966666666666667,1
MTURK,5ba2c2bc7b3bb19711ede5857611abc,3ZUE82NE0A1IH3K8BJPP5BRA6OK8FY,0.5,1.0,Ed O'Brien,3600,4,120,4,120,0,0,0.5166666666666667,1
MTURK,5ba2c2bc7b3bb19711ede5857611abc,3XWUWJ18UPUYYNQ5I8LN8PLLG2AUUH,1.0,0.0,Tom,14400,22,5100,20,1707,2,3393,1.3541666666666667,1
MTURK,5ba2c2bc7b3bb19711ede5857611abc,3RHLQY6EDVMOB6QH9EJUYXPYZD64D2,1.0,0.0,Salesforce Research,900,4,900,4,899,0,1,2.0,1
MTURK,5ba2c2bc7b3bb19711ede5857611abc,3ZURAPD287M2POED6VBHDIC5KUNF1Q,1.2,0.0,Stanford GSB Behavioral Lab,2400,5,2100,5,870,0,1230,2.25,1
MTURK,5ba2c2bc7b3bb19711ede5857611abc,33K3E8REWWV3YBR6R4LU34VR8E58XZ,2.0,0.0,Rachel Burgess,5400,400,4440,19,1639,381,2801,3.6444444444444444,1
MTURK,5ba2c2bc7b3bb19711ede5857611abc,3TKXBROM5UH798MDRKQBF1FJE9TIJR,0.3,0.0,John Robb,3600,5,690,5,688,0,2,0.3575,1
MTURK,5ba2c2bc7b3bb19711ede5857611abc,32XN26MTXZJPYLI51J21HFYXDJUL0A,3.0,1.0,David Cheng,7200,7,690,7,629,0,61,3.2875,1
MTURK,5ba2c2bc7b3bb19711ede5857611abc,33EEIIWHK8ETH1AQLH93RRHZ06HQVN,0.3,0.0,John Robb,3600,4,360,4,330,0,30,0.32999999999999996,1
MTURK,5ba2c2bc7b3bb19711ede5857611abc,3QREJ3J43444AT01U8N08W7OA2NLK7,0.3,0.0,John Robb,3600,4,360,4,330,0,30,0.32999999999999996,1
MTURK,5ba2c2bc7b3bb19711ede5857611abc,3YGYP1364125Y1G53JABM701RL1RNS,1.2,0.0,S3 Lab,18000,389,1380,8,141,381,1239,1.292,1
MTURK,5ba2c2bc7b3bb19711ede5857611abc,371QPA24C2OJTXJM127FHM9CH4RT1T,0.25,1.0,Zarren Kuzma,1200,4,270,3,111,1,159,0.30625,1
MTURK,5ba2c2bc7b3bb19711ede5857611abc,3KVQ0UJWPXLA9WOZXUE27WTSXEF5WE,0.1,1.0,Zarren Kuzma,900,3,120,3,90,0,30,0.11333333333333334,1
MTURK,5ba2c2bc7b3bb19711ede5857611abc,3B9XR6P1WEVIOBZDWDSLR8T2NMUBJJ,0.5,3.0,Lisa Catarineau,86400,1398,9270,7,115,1391,9155,0.5536458333333333,1
MTURK,5ba2c2bc7b3bb19711ede5857611abc,3O0M2G5VC629X01VVMRLU09THP149B,0.5,3.0,Lisa Catarineau,86400,1398,9270,7,115,1391,9155,0.5536458333333333,1
MTURK,5ba2c2bc7b3bb19711ede5857611abc,3KI0JD2ZU1IJY4HGZDMGD221IQJ76N,0.5,3.0,Lisa Catarineau,86400,1398,9300,7,115,1391,9185,0.5538194444444444,1
MTURK,5ba2c2bc7b3bb19711ede5857611abc,3R15W654VDPG5EA716M2OO7E2XYLQX,0.5,0.0,Goldberg Imports,86400,1305,9090,7,30,1298,9060,0.5526041666666667,1
MTURK,5ba2c2bc7b3bb19711ede5857611abc,33EEIIWHLBGP2AJK51MHNQ5QEVRQVJ,2.0,1.0,Laura,172800,2,29,2,29,0,0,2.0003356481481482,1
MTURK,5ba2c2bc7b3bb19711ede5857611abc,3Y3CZJSZAO5BOHVD35A2AMZW2W55RY,0.25,0.0,utabusiness456,3600,5,60,2,49,3,11,0.25416666666666665,1
MTURK,5ba2c2bc7b3bb19711ede5857611abc,37VE3DA4YURNPEYVOHEGU9204STHB4,0.2,1.0,Giles Templeman,86400,4,30,2,0,2,30,0.20006944444444447,1
MTURK,5ba2c2bc7b3bb19711ede5857611abc,3EAWOID6MTB9E3FKYA09NEVX1F3V03,0.5,0.0,Pelin Constantin,3600,457,2190,2,0,455,2190,0.8041666666666667,1
MTURK,5ba2c2bc7b3bb19711ede5857611abc,3M7OI89LVY07OINXMP2UBIPMB8SC6P,5.75,0.0,Honey Lab,5400,95,120,2,0,93,120,5.877777777777778,1
MTURK,5ba2c2bc7b3bb19711ede5857611abc,3BAKUKE4AKPZNTVY7Y5VCCA5MS91RB,0.15,1.0,Patrick Healey,1800,9,1740,5,1169,4,571,0.295,1
MTURK,5ba2c2bc7b3bb19711ede5857611abc,3W5PY7V3UP7YVAH1T1IG9I38EQJJYB,0.15,0.0,Hugh Stephens,600,2,120,2,120,0,0,0.18,1
MTURK,5ba2c2bc7b3bb19711ede5857611abc,39HYCOOPKOSE4LZ4NKLHGWR7CGQMDO,2.5,0.0,Ivar Vermeulen,7200,203,2490,10,1310,193,1180,3.3645833333333335,1
MTURK,5ba2c2bc7b3bb19711ede5857611abc,3WKGUBL7SZIGJH6I6QVDSCWL6Q94LR,5.0,0.0,Jon,3600,558,2310,9,650,549,1660,8.208333333333334,1
MTURK,5ba2c2bc7b3bb19711ede5857611abc,391JB9X4ZYFD7RBZDWAZORU5J0ZKMC,3.0,0.0,MPRG for Rationality Enhancement,5400,8,810,6,600,2,210,3.45,1
MTURK,5ba2c2bc7b3bb19711ede5857611abc,3UDTAB6HH5Y16EBOLHEDG64NMFR90H,0.6,0.0,Ryan Buell,3600,4,600,4,420,0,180,0.7,1
MTURK,5ba2c2bc7b3bb19711ede5857611abc,3O2Y2UIUDUHXOJBHWAZXRSW6ON0FKL,0.15,826.0,Peter Ciuffetti,300,2,330,2,330,0,0,0.315,1
MTURK,5ba2c2bc7b3bb19711ede5857611abc,3OID399FYKISYKUKCTVNE8LFNSXDFX,0.4,0.0,Elias Bouacida,7200,128,270,2,3,126,267,0.41500000000000004,1
MTURK,5ba2c2bc7b3bb19711ede5857611abc,3MQKOF1EE1N0BEDDXTWVMROBOXPWDH,0.5,0.0,Oleg Urminsky,1800,22,629,4,1,18,628,0.6747222222222222,1
MTURK,5ba2c2bc7b3bb19711ede5857611abc,3UQVX1UPGVUW5M5ALXPSKNTDZ5A20T,0.5,1.0,UPenn Researcher,3600,22,629,4,1,18,628,0.5873611111111111,1
MTURK,5ba2c2bc7b3bb19711ede5857611abc,386659BNTL48TF4D2GIJWZPO35Q10O,0.25,67.0,UCSB EMBeR Lab,2700,280,25132,19,3,261,25129,2.577037037037037,1
MTURK,5ba2c2bc7b3bb19711ede5857611abc,3UAU495MJMGW8T2WI1Y4QUV9RQHOUJ,0.5,0.0,Debbie Martinez,7200,498,2771,44,203,454,2568,0.6924305555555555,1
MTURK,5ba2c2bc7b3bb19711ede5857611abc,35U0MRQMVNVWL8RWNR89MGXS5XQOV8,0.5,0.0,Debbie Martinez,7200,515,2819,47,229,468,2590,0.6957638888888888,1
MTURK,5ba2c2bc7b3bb19711ede5857611abc,3E22YV8GG28JOHXB2WSZD24FTZINPW,0.75,0.0,Resumes,3600,124,690,3,197,121,493,0.89375,1
MTURK,5ba2c2bc7b3bb19711ede5857611abc,3SU800BH87UHJJIZZAJAR2MJ6RXUQM,0.75,0.0,Resumes,3600,5,60,3,40,2,20,0.7625,1
MTURK,5ba2c2bc7b3bb19711ede5857611abc,3VZYA8PITOWLWKXPAKA4J05BLTZ05Z,1.0,1182.0,Surveys,3600,153,3000,5,1077,148,1923,1.8333333333333335,1
MTURK,5ba2c2bc7b3bb19711ede5857611abc,3X2LT8FDHVHMBAKTV5UWWGLDT4RW8Z,0.24,61.0,Stanford GSB Behavioral Lab,900,7,900,2,542,5,358,0.48,1
MTURK,5ba2c2bc7b3bb19711ede5857611abc,3AXFSPQOYPXKGNLESVHPX0Y5WMSFJQ,2.0,0.0,Mary Zaki,1800,11,1560,6,737,5,823,3.7333333333333334,1
MTURK,5ba2c2bc7b3bb19711ede5857611abc,3BCRDCM0OEVX5D5DEUP3DR4KFSY6KR,2.5,0.0,UCSD LADLab,2700,2,120,2,120,0,0,2.611111111111111,1
MTURK,5ba2c2bc7b3bb19711ede5857611abc,3BFNCI9LYK1ZE3LL1IC2OJMVYZ837E,6.0,0.0,remesh,7200,51,1830,51,1499,0,331,7.525,1
MTURK,5ba2c2bc7b3bb19711ede5857611abc,3KVQ0UJWPYJVRYE9ELZLLRRSYTA5WU,2.0,0.0,Devleena Das,1800,25,1410,25,1409,0,1,3.5666666666666664,1
MTURK,5ba2c2bc7b3bb19711ede5857611abc,3FK4G712NXYM3VFCVI6WMHLMU5QSSG,1.0,1128.0,Surveys,3600,25,300,25,299,0,1,1.0833333333333333,1
MTURK,5ba2c2bc7b3bb19711ede5857611abc,3X52SWXE0X3Z3V7PI1QX41KPEF0WC5,1.0,1128.0,Surveys,3600,25,300,25,299,0,1,1.0833333333333333,1
MTURK,5ba2c2bc7b3bb19711ede5857611abc,3ABAOCJ4R827SKNUJHL5F87FKSNQMD,1.0,1128.0,Surveys,3600,25,300,25,299,0,1,1.0833333333333333,1
MTURK,5ba2c2bc7b3bb19711ede5857611abc,3P7QK0GJ3TJQZ8KSWVLYRS5LJQRZ2P,1.0,1128.0,Surveys,3600,25,269,25,269,0,0,1.0747222222222221,1
MTURK,5ba2c2bc7b3bb19711ede5857611abc,35YHTYFL1G1TRIRUJTB2Q5ME4JQFVP,1.0,1128.0,Surveys,3600,23,269,23,269,0,0,1.0747222222222221,1
MTURK,5ba2c2bc7b3bb19711ede5857611abc,3FHTJGYT8NYM0YQT818L2YX8JAPGP4,1.0,1128.0,Surveys,3600,26,269,26,269,0,0,1.0747222222222221,1
MTURK,5ba2c2bc7b3bb19711ede5857611abc,3RSBJ6YZECOY1YIXIHPOVDS68QTFON,1.0,1128.0,Surveys,3600,24,269,24,269,0,0,1.0747222222222221,1
MTURK,5ba2c2bc7b3bb19711ede5857611abc,3IH9TRB0FBXXFXDMDNXYMESQV7BI1U,1.0,1128.0,Surveys,3600,28,269,28,269,0,0,1.0747222222222221,1
MTURK,5ba2c2bc7b3bb19711ede5857611abc,3QD8LUVX4XWTTA30DWZBSESMV0K5XZ,1.0,1128.0,Surveys,3600,24,269,24,269,0,0,1.0747222222222221,1
MTURK,5ba2c2bc7b3bb19711ede5857611abc,3SA4EMRVJV0PPUF8UZJIH6ASCT10PM,1.0,1128.0,Surveys,3600,25,269,25,269,0,0,1.0747222222222221,1
MTURK,5ba2c2bc7b3bb19711ede5857611abc,3S829FDFT2ZOXNITS2HUQQGE8HIDXF,1.0,1128.0,Surveys,3600,25,269,25,269,0,0,1.0747222222222221,1
MTURK,5ba2c2bc7b3bb19711ede5857611abc,351S7I5UG9UWOF4H0SGWVMKTBN5NJJ,1.0,1128.0,Surveys,3600,25,269,25,269,0,0,1.0747222222222221,1
MTURK,5ba2c2bc7b3bb19711ede5857611abc,329E6HTMSW0KVVHP0UWTNNM0LVEK3Z,1.0,1128.0,Surveys,3600,24,269,24,269,0,0,1.0747222222222221,1
MTURK,5ba2c2bc7b3bb19711ede5857611abc,3UEDKCTP9VO2WEIC26ZJ04YGQX07KR,1.0,1128.0,Surveys,3600,26,269,26,269,0,0,1.0747222222222221,1
MTURK,5ba2c2bc7b3bb19711ede5857611abc,3G9UA71JVVS7LUCUKLZ7ZPY3B80J74,1.0,1128.0,Surveys,3600,24,269,24,269,0,0,1.0747222222222221,1
MTURK,5ba2c2bc7b3bb19711ede5857611abc,3511RHPADVCNY3K9WK9QKL2VG9ZLR7,1.0,1128.0,Surveys,3600,26,269,26,269,0,0,1.0747222222222221,1
MTURK,5ba2c2bc7b3bb19711ede5857611abc,3XJOUITW8UPB5FDESEMH1M27E0JQTE,1.0,1128.0,Surveys,3600,25,269,25,269,0,0,1.0747222222222221,1
MTURK,5ba2c2bc7b3bb19711ede5857611abc,37VUR2VJ6AN62URMLD1CBBUVI2S1CC,1.0,1128.0,Surveys,3600,25,269,25,269,0,0,1.0747222222222221,1
MTURK,5ba2c2bc7b3bb19711ede5857611abc,3QO7EE372OLB9TJXSSVW1SWL8TJQBO,1.0,1128.0,Surveys,3600,25,269,25,269,0,0,1.0747222222222221,1
MTURK,5ba2c2bc7b3bb19711ede5857611abc,3ZLW647WALTPEFDZBOQPNR064VS32W,1.0,1128.0,Surveys,3600,25,269,25,269,0,0,1.0747222222222221,1
MTURK,5ba2c2bc7b3bb19711ede5857611abc,30Y6N4AHYPU40RWHJ3B218UQ70XDRJ,1.0,1128.0,Surveys,3600,25,269,25,269,0,0,1.0747222222222221,1
MTURK,5ba2c2bc7b3bb19711ede5857611abc,3087LXLJ6MEDYHQEGWND5CWOANDF0X,1.0,1128.0,Surveys,3600,25,269,25,269,0,0,1.0747222222222221,1
MTURK,5ba2c2bc7b3bb19711ede5857611abc,3DTJ4WT8BDDIUOW8PFGZTTEAGTHZER,1.0,1128.0,Surveys,3600,25,269,25,269,0,0,1.0747222222222221,1
MTURK,5ba2c2bc7b3bb19711ede5857611abc,34YWR3PJ2ABZSGUAVQCBGF5JYWE0XA,4.0,0.0,Amazon Requester Inc. - SSI,7200,183,870,3,0,180,870,4.483333333333333,1
MTURK,5ba2c2bc7b3bb19711ede5857611abc,3BFF0DJK8XNQWI3740G41NMPFCYST7,4.0,0.0,remesh,7200,495,4079,21,182,474,3897,6.266111111111111,1
MTURK,5ba2c2bc7b3bb19711ede5857611abc,32CAVSKPCFHWC78G0V86PMNVGYNU1U,2.0,0.0,antony wong,3600,456,3450,11,182,445,3268,3.916666666666667,1
MTURK,5ba2c2bc7b3bb19711ede5857611abc,3DTJ4WT8BDDIUOW8PFGZTTEAGTHEZ6,1.0,1054.0,Surveys,3600,16,330,9,13,7,317,1.0916666666666666,1
MTURK,5ba2c2bc7b3bb19711ede5857611abc,3PKVGQTFIHI7Y2R8FZYGET4RPO3RY5,1.0,1053.0,Surveys,3600,13,540,10,12,3,528,1.15,1
MTURK,5ba2c2bc7b3bb19711ede5857611abc,3EHIMLB7F7XFU2MN6QOS1CEJ9028HB,1.0,1053.0,Surveys,3600,13,540,10,12,3,528,1.15,1
MTURK,5ba2c2bc7b3bb19711ede5857611abc,3TLFH2L6Y9MUDWBTQ3WG5444YU5T23,1.0,1053.0,Surveys,3600,13,540,10,12,3,528,1.15,1
MTURK,5ba2c2bc7b3bb19711ede5857611abc,39XCQ6V3KY2GAVJ4C9QLS1F2YWM657,1.0,1053.0,Surveys,3600,15,540,12,12,3,528,1.15,1
MTURK,5ba2c2bc7b3bb19711ede5857611abc,3T5ZXGO9DEM7RRMDY6BZNA3OZW5ZQ3,1.0,1053.0,Surveys,3600,12,540,9,12,3,528,1.15,1
MTURK,5ba2c2bc7b3bb19711ede5857611abc,3KA7IJSNW63Q9HIISFG71N6B3XXPBW,1.0,1053.0,Surveys,3600,12,540,9,12,3,528,1.15,1
MTURK,5ba2c2bc7b3bb19711ede5857611abc,32TMVRKDGNWLIQYSRJ497N5F4VH48M,1.0,1053.0,Surveys,3600,13,540,10,12,3,528,1.15,1
MTURK,5ba2c2bc7b3bb19711ede5857611abc,3EHVO81VN5TJYNOYBOWS5CG66WH1H0,0.15,3714.0,Anita,3600,562,1110,3,16,559,1094,0.19624999999999998,1
MTURK,5ba2c2bc7b3bb19711ede5857611abc,388CL5C1RL7GS5WQ2J8S3KSMMTCLH9,0.5,1.0,MOONSU KOO,1800,480,1830,4,137,476,1693,1.0083333333333333,1
MTURK,5ba2c2bc7b3bb19711ede5857611abc,3JMNNNO3B14QQTBMMNFWWC7PUSIW2F,1.0,11.0,Haemin Joo,3600,514,1860,7,975,507,885,1.5166666666666666,1
MTURK,5ba2c2bc7b3bb19711ede5857611abc,3MGHRFQY2NHCOW7M3O94AQST4U70Y2,1.0,1.0,Yu Research Group,5400,443,1950,10,1020,433,930,1.3611111111111112,1
MTURK,5ba2c2bc7b3bb19711ede5857611abc,3SA4EMRVJVDS3HQOEHO0M7F9VH00PT,4.0,0.0,remesh,7200,700,2520,17,1230,683,1290,5.4,1
MTURK,5ba2c2bc7b3bb19711ede5857611abc,3D0LPO3EAB9J5TU8OM0IT1O3R5GYOM,1.0,0.0,MSBLabResearch,2400,4,570,4,540,0,30,1.2375,1
MTURK,5ba2c2bc7b3bb19711ede5857611abc,3DWNFENNE3VTTJV0EMQYJPGNKPC4JN,3.0,0.0,jennifer j ratcliff,7200,1708,5009,64,803,1644,4206,5.087083333333334,1
MTURK,5ba2c2bc7b3bb19711ede5857611abc,3ROUCZ907F47BFQ6IZRKRAQ1DVIOO2,0.75,0.0,MSBLabResearch,2400,613,1500,14,399,599,1101,1.21875,1
MTURK,5ba2c2bc7b3bb19711ede5857611abc,32204AGAACEYOELK8VEDI40DB4OHGA,0.7,3.0,NYU Bowman Group,86400,31,60,4,30,27,30,0.700486111111111,1
MTURK,5ba2c2bc7b3bb19711ede5857611abc,3UL5XDRDNCE3E8EDJG07VVRLRQ358J,2.0,0.0,Victor Kuperman,7200,1163,3689,53,573,1110,3116,3.0247222222222225,1
MTURK,5ba2c2bc7b3bb19711ede5857611abc,3IYI9285WSECI4NKPAYNQFY1P1NJCL,1.0,0.0,CAH,3600,148,450,5,223,143,227,1.125,1
MTURK,5ba2c2bc7b3bb19711ede5857611abc,3VDI8GSXAESTDQ13JZFZAON8MAE8G8,3.0,0.0,WHU - Otto Beisheim School of Management - (RMR),1800,191,1410,10,269,181,1141,5.35,1
MTURK,5ba2c2bc7b3bb19711ede5857611abc,3X52SWXE10JWJ5E2GMK1SZ16Z5ICWN,1.0,1.0,zhibo xu,1200,6,360,6,180,0,180,1.3,1
MTURK,5ba2c2bc7b3bb19711ede5857611abc,3CESM1J3EH2B3SVBTK6SP6ASGKKW6N,0.2,1.0,Cornell University Research,1800,3,180,3,60,0,120,0.22,1
MTURK,5ba2c2bc7b3bb19711ede5857611abc,3TZDZ3Y0JS66D6MUSK0ZHRSVBUE19X,0.5,0.0,GilbertLab,3600,102,450,4,90,98,360,0.5625,1
MTURK,5ba2c2bc7b3bb19711ede5857611abc,3X4Q1O9UBHNP0FLAH1ADBT3E2MFO7G,2.0,1.0,Uri Ort,900,38,570,13,272,25,298,3.2666666666666666,1
MTURK,5ba2c2bc7b3bb19711ede5857611abc,31YWE12TE0DCUOZ2ISX9U6U7EQKX7U,2.0,1.0,Uri Ort,900,60,450,33,243,27,207,3.0,1
MTURK,5ba2c2bc7b3bb19711ede5857611abc,31JUPBOORN4PBUEJJIWZQKSYP2DL8X,0.15,0.0,Hugh Stephens,600,40,210,31,176,9,34,0.20249999999999999,1
MTURK,5ba2c2bc7b3bb19711ede5857611abc,3DTJ4WT8CGSL2NNGIBXLSN5OEH9EZT,0.3,1.0,UPenn Researcher,3600,117,150,3,17,114,133,0.3125,1
MTURK,5ba2c2bc7b3bb19711ede5857611abc,32LAQ1JNT9IV96D649RS0HTDN32UTD,1.2,36.0,S3 Lab,18000,11,30,4,0,7,30,1.202,1
MTURK,5ba2c2bc7b3bb19711ede5857611abc,3TD33TP5DLKAC78FCZE9ILHPDUDAB6,1.15,1.0,IMC Lab,2700,650,1320,39,16,611,1304,1.712222222222222,0
MTURK,5ba2c2bc7b3bb19711ede5857611abc,3I6NF2WGIGWQ2KHGATSG18DZRVTG5N,0.15,0.0,Hugh Stephens,600,212,450,23,5,189,445,0.2625,1
MTURK,5ba2c2bc7b3bb19711ede5857611abc,3ZRKL6Z1E83ON47F3D163MIWDLHSGN,0.5,0.0,Behavioral Science Lab,1200,6,930,4,827,2,103,0.8875,1
MTURK,5ba2c2bc7b3bb19711ede5857611abc,34OWYT6U3Y4D2W9FQJNPS7QSCNB9IY,3.0,0.0,Samantha Rundle,18000,5,420,5,420,0,0,3.07,1
MTURK,5ba2c2bc7b3bb19711ede5857611abc,3QX22DUVPRU25RAJYCW1KPX1Z82MVY,0.3,1.0,UPenn Researcher,3600,3,240,3,240,0,0,0.32,1
MTURK,5ba2c2bc7b3bb19711ede5857611abc,30F94FBDNRKOQUM1VNTAB21YLE9TBC,0.4,0.0,Tae Seok Oh,3600,83,1560,3,178,80,1382,0.5733333333333334,1
MTURK,5ba2c2bc7b3bb19711ede5857611abc,341H3G5YG3VHLYHSC3WNGA0YBQVZ08,2.5,0.0,Ruoyang Hu,3600,87,300,4,173,83,127,2.7083333333333335,1
MTURK,5ba2c2bc7b3bb19711ede5857611abc,3LVTFB9DE4H49H3VGLE2NTHS3YGQGN,0.6,8.0,Ryan Buell,3600,38,60,3,1,35,59,0.61,1
MTURK,5ba2c2bc7b3bb19711ede5857611abc,3QO7EE373RRBMOY08CMQF5WL9TLQBV,2.0,0.0,Kyb Lab,2100,17,60,2,52,15,8,2.057142857142857,1
MTURK,5ba2c2bc7b3bb19711ede5857611abc,3PUOXASB57361SADJ9O7XVHJMQ59ZV,1.25,0.0,Lea Dunn,3600,273,2820,35,1033,238,1787,2.229166666666667,1
MTURK,5ba2c2bc7b3bb19711ede5857611abc,3XBYQ44Z7T8ANVYAF1MWQR3UFPZWTO,3.0,0.0,Yael Niv,3600,4,570,4,570,0,0,3.475,1
MTURK,5ba2c2bc7b3bb19711ede5857611abc,31HLTCK4BLWHN5IYGLXE4ZREWBCGV1,5.0,0.0,Ranjitha,5400,242,2790,37,1117,205,1673,7.583333333333334,1
MTURK,5ba2c2bc7b3bb19711ede5857611abc,30EV7DWJTVWMU68587X01VN1R5LY6X,5.0,0.0,Guan Soon Khoo,10800,3,29,3,0,0,29,5.013425925925926,1
MTURK,5ba2c2bc7b3bb19711ede5857611abc,3VMHWJRYHVGDO5EXR3409BP34I4XFM,5.0,0.0,Eric Joaquin,4500,151,720,28,458,123,262,5.8,1
MTURK,5ba2c2bc7b3bb19711ede5857611abc,3EHVO81VN5LUOEGLU2AHW790SU01HQ,0.7,1.0,Patrick,3600,211,1290,31,607,180,683,0.9508333333333332,1
MTURK,5ba2c2bc7b3bb19711ede5857611abc,3LXX8KJXPW9XVK0Q12I5IXR34DBO9H,0.15,0.0,Hugh Stephens,600,59,150,25,129,34,21,0.1875,1
MTURK,5ba2c2bc7b3bb19711ede5857611abc,3NCN4N1H1GZHWQ24L3JE4R1PC2GNB9,1.15,1.0,IMC Lab,2700,8,600,6,479,2,121,1.4055555555555554,1
MTURK,5ba2c2bc7b3bb19711ede5857611abc,3YLTXLH3EITA3SD8MLDO3SSSYL0PHF,3.0,0.0,Dmitry Taubinsky,10800,90,1290,7,180,83,1110,3.3583333333333334,1
MTURK,5ba2c2bc7b3bb19711ede5857611abc,33N1S8XHHMLMWMFT3ZUK1K1MXAK1Z0,2.0,1.0,Julie Johnson,7200,73,540,3,150,70,390,2.15,1
MTURK,5ba2c2bc7b3bb19711ede5857611abc,3VJ4PFXFK7PN9B4LTM0B1HXLFVJAUK,2.0,0.0,View Health & Wellness,1200,42,660,29,506,13,154,3.1,1
MTURK,5ba2c2bc7b3bb19711ede5857611abc,3GVPRXWRPHUJLF1UOA7GK44BXEQ7IV,0.15,0.0,Hugh Stephens,600,33,30,24,23,9,7,0.1575,1
MTURK,5ba2c2bc7b3bb19711ede5857611abc,3ZVPAMTJXRRG0OTHQOQRGAZNT67GR7,0.5,1.0,Debbie Martinez,7200,87,6330,73,5408,14,922,0.9395833333333333,1
MTURK,5ba2c2bc7b3bb19711ede5857611abc,31MCUE39CNZI18CE3ZS0OPLLC213GE,0.4,1.0,UPenn Researcher,3600,2,30,2,30,0,0,0.4033333333333334,1
MTURK,5ba2c2bc7b3bb19711ede5857611abc,30OITAWPBSMNV3KTRLKEHT38JO49H2,2.0,0.0,Brown University Mindfulness Center,1800,3,1590,3,1590,0,0,3.7666666666666666,1
MTURK,5ba2c2bc7b3bb19711ede5857611abc,3UUSLRKAVPQAW8SFLAEGZEHBGBE7D6,0.5,0.0,Behave4,600,34,330,28,264,6,66,0.775,1
MTURK,5ba2c2bc7b3bb19711ede5857611abc,32K26U12DNO4OUM4EU9LZL41RRPVD9,0.15,0.0,Hugh Stephens,600,33,60,27,54,6,6,0.16499999999999998,1
MTURK,5ba2c2bc7b3bb19711ede5857611abc,301KG0KX9CWQGR5I04AFHP5WKYU2HA,0.5,0.0,Sven Mikolon,1800,41,780,33,1395,8,-615,0.7166666666666667,1
MTURK,5ba2c2bc7b3bb19711ede5857611abc,3S1L4CQSFX5HUQX2U5DFRYT9IU5AFZ,0.15,0.0,Hugh Stephens,600,36,120,29,938,7,-818,0.18,1
MTURK,5ba2c2bc7b3bb19711ede5857611abc,3CIS7GGG65KE7EOBCD70918CWCFUEN,1.5,0.0,Julia B Bear,1800,3,1770,3,1769,0,1,2.975,1
MTURK,5ba2c2bc7b3bb19711ede5857611abc,3VDVA3ILIDFQRRCVIG0CSFKAX8DG1Q,0.75,0.0,Markus Kemmelmeier,3600,17,2070,11,3019,6,-949,1.18125,0
MTURK,5ba2c2bc7b3bb19711ede5857611abc,31GN6YMHLPAFDQBSR1E57HIFF08WSA,0.25,0.0,K Baum,300,339,300,2,6,337,294,0.5,1
MTURK,5ba2c2bc7b3bb19711ede5857611abc,3XBXDSS888JFQVFRRQ8R6J9RGB1LXK,0.15,0.0,Hugh Stephens,600,2,90,2,90,0,0,0.1725,1
MTURK,5ba2c2bc7b3bb19711ede5857611abc,306996CF6VJCC72X1TPLUSLK5YH1BK,0.5,0.0,Stanford GSB Behavioral Lab,1800,6,1830,4,1140,2,690,1.0083333333333333,1
MTURK,5ba2c2bc7b3bb19711ede5857611abc,33QQ60S6ASIZYTFRF02S7PJK3330US,3.0,0.0,Dynamic Cognition Lab,5400,7,5400,5,961,2,4439,6.0,1
MTURK,5ba2c2bc7b3bb19711ede5857611abc,3W0KKJIARQ8VGAQC6RBT85RI6YVK86,0.5,0.0,Stanford GSB Behavioral Lab,1800,5,1800,3,151,2,1649,1.0,1
MTURK,5ba2c2bc7b3bb19711ede5857611abc,3VZYA8PITOYTRG6VWR3DGGQJKFI05K,0.15,0.0,Hugh Stephens,600,53,420,35,405,18,15,0.255,0
MTURK,5ba2c2bc7b3bb19711ede5857611abc,3R15W654VDTCJLEL3JRHYIUDXP3LQB,0.3,0.0,UM,3600,53,330,35,316,18,14,0.3275,0
MTURK,5ba2c2bc7b3bb19711ede5857611abc,3YKP7CX6G2F5CO6O92N0073YPIS7BW,1.0,0.0,Acme Data Collection,3600,30,60,3,0,27,60,1.0166666666666666,1
MTURK,5ba2c2bc7b3bb19711ede5857611abc,3S37Y8CWI8VN97V3ACVG4LK2E9HW46,1.1,0.0,Maze,7200,126,5789,12,3056,114,2733,1.984430555555556,1
MTURK,5ba2c2bc7b3bb19711ede5857611abc,3APP19WN71FJPEECKV1RUBRJMLWG6D,3.0,1.0,Laura Nicholson,5400,98,4950,8,3056,90,1894,5.75,1
MTURK,5ba2c2bc7b3bb19711ede5857611abc,334ZEL5JX5E8W6CR6SS7PER2AFBOST,3.0,0.0,Kuperberg Lab,21600,88,960,2,816,86,144,3.1333333333333333,1
MTURK,5ba2c2bc7b3bb19711ede5857611abc,3NSM4HLQNQTNXHO35QCQQIORZABQQH,0.36,1.0,Stanford GSB Behavioral Lab,1800,7,1800,3,1670,4,130,0.72,1
MTURK,5ba2c2bc7b3bb19711ede5857611abc,3RDTX9JRTZ8LECS8MHV1ZIB74SJ97D,0.3,0.0,John Robb,3600,9,3390,5,1700,4,1690,0.5825,1
MTURK,5ba2c2bc7b3bb19711ede5857611abc,39TX062QY5AXQ006SFWXBCHG3B5X3S,8.0,0.0,RipollesLab,10800,759,3570,80,153,679,3417,10.644444444444444,1
MTURK,5ba2c2bc7b3bb19711ede5857611abc,3GL25Y6843UZWDXCR2966WOGGHUMXS,0.15,0.0,Hugh Stephens,600,266,210,32,11,234,199,0.20249999999999999,1
MTURK,5ba2c2bc7b3bb19711ede5857611abc,3M47JKRKCZL01BRW0UUGBONES2R86Y,3.0,10.0,Ma Study,3600,344,2910,86,64,258,2846,5.425000000000001,0
MTURK,5ba2c2bc7b3bb19711ede5857611abc,33N1S8XHHMLR5JB2ZYETJPGOQ6Y1ZX,0.15,0.0,Hugh Stephens,600,45,60,28,27,17,33,0.16499999999999998,1
MTURK,5ba2c2bc7b3bb19711ede5857611abc,3XBXDSS888KNH7I9BKMLE1P3V8TXLI,2.2,26.0,PsychLabAtBC,10800,53,2010,3,5,50,2005,2.6094444444444447,1
MTURK,5ba2c2bc7b3bb19711ede5857611abc,3VQTAXTYN3LBWIZKV88A89EIA0BUBL,0.15,0.0,Hugh Stephens,600,52,30,22,16,30,14,0.1575,1
MTURK,5ba2c2bc7b3bb19711ede5857611abc,3HEA4ZVWWH9AVDHIRYFST9EGKB4556,3.0,0.0,Conversionxl LLC,3600,688,2280,40,91,648,2189,4.9,1
MTURK,5ba2c2bc7b3bb19711ede5857611abc,30Z7M1Q8V27QO1C1KSDCD44TEF6A8J,4.0,0.0,Conversionxl LLC,3600,603,2160,40,84,563,2076,6.4,1
MTURK,5ba2c2bc7b3bb19711ede5857611abc,3AQN9REUTFGLSOH9J5W56K8V99ZDYA,0.15,0.0,Hugh Stephens,600,52,74,36,50,16,24,0.16849999999999998,1
MTURK,5ba2c2bc7b3bb19711ede5857611abc,3WUVMVA7PE9CTO5GIE8FYVCG3GPAZB,3.0,0.0,Hulabrow Lab,5400,1153,2730,6,58,1147,2672,4.516666666666667,1
MTURK,5ba2c2bc7b3bb19711ede5857611abc,373L46LKP7P2CDTP0CATIN3WZM1JKY,0.5,171.0,Jacob Brazeal,300,15,210,2,28,13,182,0.8500000000000001,1
MTURK,5ba2c2bc7b3bb19711ede5857611abc,3EQPA8A374FX18SB0DD352R93VEJZK,0.5,0.0,Jacob Brazeal,300,4,120,4,120,0,0,0.7,1
MTURK,5ba2c2bc7b3bb19711ede5857611abc,3VP28W7DUN3HW66FHNMIQ4ZHAOXZFX,0.5,0.0,Jacob Brazeal,300,23,150,4,120,19,30,0.75,1
MTURK,5ba2c2bc7b3bb19711ede5857611abc,3OYHVNTV5THGDOKMGP2YQJKIYGBOKM,0.5,0.0,Jacob Brazeal,300,4,120,4,120,0,0,0.7,1
MTURK,5ba2c2bc7b3bb19711ede5857611abc,32LAQ1JNT8OWQT8Z1EQ09IP1XSNTU4,0.7,0.0,Elise Chandon,3600,213,270,4,4,209,266,0.7525,1
MTURK,5ba2c2bc7b3bb19711ede5857611abc,3OID399FXIE57EM4QLI0D5QFK0SFDQ,2.5,0.0,Abigail,3600,957,2700,86,885,871,1815,4.375,1
MTURK,5ba2c2bc7b3bb19711ede5857611abc,3UYRNV2KJXNGSBV7EJXMFDDF4REN8L,0.5,1.0,Debbie Martinez,7200,266,359,27,66,239,293,0.5249305555555556,1
MTURK,5ba2c2bc7b3bb19711ede5857611abc,37NXA7GVST6NM6AWRB79IYC6029LV1,0.15,0.0,Hugh Stephens,600,423,420,36,34,387,386,0.255,1
MTURK,5ba2c2bc7b3bb19711ede5857611abc,3D3B8GE894D24XRJSJ5LFW5Q7NC9PZ,5.0,0.0,Ayon Sen,4800,16,1740,8,783,8,957,6.8125,1
MTURK,5ba2c2bc7b3bb19711ede5857611abc,3XBXDSS888JRJYXSI8BR7BHXAKZLX0,0.0,0.0,SurveyComet,108000,5,780,5,779,0,1,0.0,1
MTURK,5ba2c2bc7b3bb19711ede5857611abc,3ULIZ0H1V94ICGUUEA5WIVIV5FB15Q,0.6,8.0,Ryan Buell,3600,3,480,3,480,0,0,0.6799999999999999,1
MTURK,5ba2c2bc7b3bb19711ede5857611abc,3HY86PZXQ245DDOQVN6IGL8M5DIE1N,2.5,0.0,Michael Kowalski,7200,601,1530,54,73,547,1457,3.03125,1
MTURK,5ba2c2bc7b3bb19711ede5857611abc,3TFJJUELSHPLMBIOQOUZDAP89V42CW,0.15,0.0,Hugh Stephens,600,66,60,17,3,49,57,0.16499999999999998,1
MTURK,5ba2c2bc7b3bb19711ede5857611abc,37VHPF5VZFGRLT2FDURDPF8HUYK8CO,0.3,1.0,UPenn Researcher,1800,2,30,2,30,0,0,0.305,1
MTURK,5ba2c2bc7b3bb19711ede5857611abc,36AZSFEYZ40QKVP439Z07XPGP61BVZ,1.2,0.0,Altsuss,3600,20,30,2,10,18,20,1.21,1
MTURK,5ba2c2bc7b3bb19711ede5857611abc,3ZZAYRN1I6YJIHJ3HH0VKMEQDPOTO1,0.25,0.0,Sarah,7200,416,2820,6,1522,410,1298,0.34791666666666665,1
MTURK,5ba2c2bc7b3bb19711ede5857611abc,3LCXHSGDLT6PQZOMK00D5MHU7IFSE6,12.0,1.0,Randy Corpuz,10800,1030,5370,17,1940,1013,3430,17.96666666666667,1
MTURK,5ba2c2bc7b3bb19711ede5857611abc,3M93N4X8HLK18STH01TFCJOREOHSJ6,2.5,0.0,URPP Social Networks (University of Zurich),7200,1028,4320,15,891,1013,3429,4.0,1
MTURK,5ba2c2bc7b3bb19711ede5857611abc,3JHB4BPSFL3T9F2H7FHTV1MEI949Q8,2.49,0.0,MTurk Prod,4972,391,1320,2,262,389,1058,3.1510619469026553,1
MTURK,5ba2c2bc7b3bb19711ede5857611abc,359AP8GAGGSWIWTEEQ08AYP0E7AC71,1.0,0.0,PROS,3600,491,2040,10,419,481,1621,1.5666666666666667,1
MTURK,5ba2c2bc7b3bb19711ede5857611abc,3TTPFEFXCTL5NSE2WATDQYTVQDX6H1,2.0,0.0,Janet Swim,3600,34,360,3,176,31,184,2.2,1
MTURK,5ba2c2bc7b3bb19711ede5857611abc,3H5TOKO3D9QRORKHG5JZC5RG95964Q,0.41,1.0,Imanol Arrieta Ibarra,600,35,300,3,87,32,213,0.615,1
MTURK,5ba2c2bc7b3bb19711ede5857611abc,3MQY1YVHS3RCHRSFM907GJVUG8EB2Z,0.05,1.0,VCU CSTP,1500,4,240,4,240,0,0,0.058,1
MTURK,5ba2c2bc7b3bb19711ede5857611abc,3T8DUCXY0NLCYVC0J4A4KYQAM8U9TK,0.1,9.0,PAR,720,2,30,2,30,0,0,0.10416666666666667,1
MTURK,5ba2c2bc7b3bb19711ede5857611abc,3WPCIUYH1AD1TIKDLUZMKF8V2AGDTN,3.75,0.0,Research Methods,7200,120,1860,42,951,78,909,4.71875,1
MTURK,5ba2c2bc7b3bb19711ede5857611abc,37VHPF5VYCHD09C3ZOVWED2HT3SC83,1.0,1.0,interactive_experiments,3600,54,1020,42,951,12,69,1.2833333333333332,1
MTURK,5ba2c2bc7b3bb19711ede5857611abc,3ZQX1VYFTD5XHFHGWACRI1WSKAJO8O,0.15,0.0,Hugh Stephens,600,38,90,30,82,8,8,0.1725,1
MTURK,5ba2c2bc7b3bb19711ede5857611abc,3SX4X51T809B03AVT8W5ES2NAYJOAS,0.15,0.0,Hugh Stephens,600,49,60,38,22,11,38,0.16499999999999998,1
MTURK,5ba2c2bc7b3bb19711ede5857611abc,3OID399FXG7XXD93RKNY19DWBGNDF5,2.5,1.0,David Cheng,3600,343,3614,50,803,293,2811,5.009722222222223,1
MTURK,5ba2c2bc7b3bb19711ede5857611abc,32CAVSKPCEFHHKFQ9L3Y3PP1QL8U1P,3.5,59.0,EMP Lab,7200,85,120,3,0,82,120,3.558333333333333,1
MTURK,5ba2c2bc7b3bb19711ede5857611abc,3FTID4TN8LY4Q051WMUTPXG0IKHYLV,0.15,0.0,Hugh Stephens,600,35,30,28,6,7,24,0.1575,1
MTURK,5ba2c2bc7b3bb19711ede5857611abc,373L46LKQBVZ6BZ064IV849LAPRJK6,0.5,0.0,Sarie Marais,86400,365,3780,3,784,362,2996,0.521875,1
MTURK,5ba2c2bc7b3bb19711ede5857611abc,38Z7YZ2SB32TRX69K9GMKVL6277QI7,0.15,0.0,Hugh Stephens,600,78,120,20,20,58,100,0.18,1
MTURK,5ba2c2bc7b3bb19711ede5857611abc,3M4KL7H8KWUDH9S0ZA6DL00IA9N16M,0.8,1.0,SH,1200,234,570,25,166,209,404,1.1800000000000002,1
MTURK,5ba2c2bc7b3bb19711ede5857611abc,391FPZIE4CMCZAG4IUO62XGF4GVHUI,3.0,0.0,SNAP,3600,551,3600,50,252,501,3348,6.0,1
MTURK,5ba2c2bc7b3bb19711ede5857611abc,3XH7ZM9YX2U0SXS6TUZ9CSW8F3MR9Q,0.15,0.0,Hugh Stephens,600,45,35,22,6,23,29,0.15875,1
MTURK,5ba2c2bc7b3bb19711ede5857611abc,3LAZVA75NIXS3BKPLFI73ZMG2NLO26,2.0,0.0,MSRNE researchers,3600,72,3150,24,45,48,3105,3.75,1
MTURK,5ba2c2bc7b3bb19711ede5857611abc,3E6L1VR4XWMG7OLZ4SW3BTRNME46F0,0.15,0.0,Hugh Stephens,600,25,33,17,2,8,31,0.15825,1
MTURK,5ba2c2bc7b3bb19711ede5857611abc,3CESM1J3EISKXKHJDU9MAOOKY9NW6Q,2.0,0.0,Shaojin Ding,3600,418,2940,18,318,400,2622,3.6333333333333333,1
MTURK,5ba2c2bc7b3bb19711ede5857611abc,3PUV2Q8SV4TRUQYNSQL4TGLR5UTBDI,2.5,0.0,Shaojin Ding,3600,354,1530,15,228,339,1302,3.5625,1
MTURK,5ba2c2bc7b3bb19711ede5857611abc,3QE4DGPGBR0ALBN5F1CPRNII8USG4R,2.0,0.0,Shaojin Ding,3600,417,2940,17,108,400,2832,3.6333333333333333,1
MTURK,5ba2c2bc7b3bb19711ede5857611abc,34HEO7RUG6G6FZIQOAI8V86NUEZRA3,0.5,1.0,Mandy Alexander,10800,308,930,12,51,296,879,0.5430555555555555,1
MTURK,5ba2c2bc7b3bb19711ede5857611abc,3A520CCNWOUFLEW5PW34JBLZZ9DAEQ,1.01,758.0,AQ Surveys,5400,115,480,5,2,110,478,1.0997777777777777,1
MTURK,5ba2c2bc7b3bb19711ede5857611abc,3L1EFR8WWU2WCQJCAFM800824T7F9R,2.0,1.0,Reg Tucker,1500,242,1050,10,1,232,1049,3.4,1
MTURK,5ba2c2bc7b3bb19711ede5857611abc,3E22YV8GG16C6L972EP8J3H5JC5PNT,1.0,1.0,David,3600,1180,3600,6,105,1174,3495,2.0,1
MTURK,5ba2c2bc7b3bb19711ede5857611abc,3PUV2Q8SW8IHX1IJ1O929YN29RHDBE,0.08,0.0,Ludolab CMU,3600,511,690,2,0,509,690,0.09533333333333334,1
MTURK,5ba2c2bc7b3bb19711ede5857611abc,3RBI0I35XE3NAWFCQGQTTBMJIYUY3L,0.15,0.0,Hugh Stephens,600,77,600,2,104,75,496,0.3,1
MTURK,5ba2c2bc7b3bb19711ede5857611abc,3S1L4CQSG1T8LPO6Z1W060XMWZPFAE,0.75,1.0,Survey Launcher,1800,367,990,2,9,365,981,1.1625,1
MTURK,5ba2c2bc7b3bb19711ede5857611abc,32204AGAABCD1X123UBU6GS51QFGHV,0.5,2.0,Derek J Koehler,3600,141,3334,17,133,124,3201,0.9630555555555556,1
MTURK,5ba2c2bc7b3bb19711ede5857611abc,3K1H3NEY7LZJWX2N1OI695XDHAXGDQ,0.84,0.0,Yale Cognition & Development Lab,2400,24,120,3,98,21,22,0.882,1
MTURK,5ba2c2bc7b3bb19711ede5857611abc,3ZXNP4Z39RL1HPKNMHSI2LKY8ON7LG,0.5,6.0,Lisa Catarineau,86400,718,3153,24,5,694,3148,0.5182465277777778,1
MTURK,5ba2c2bc7b3bb19711ede5857611abc,3IV1AEQ4DRDZMD16T18B0631FJX8JB,0.5,6.0,Lisa Catarineau,86400,719,3153,25,5,694,3148,0.5182465277777778,1
MTURK,5ba2c2bc7b3bb19711ede5857611abc,3ZXV7Q5FJBOLTE5NRNXVNU7SC3SCF9,0.5,3.0,Lisa Catarineau,86400,785,3243,55,11,730,3232,0.5187673611111111,1
MTURK,5ba2c2bc7b3bb19711ede5857611abc,3MQY1YVHS3KIIF15PSMTSR7LLEN2B8,0.5,3.0,Lisa Catarineau,86400,864,3333,76,14,788,3319,0.5192881944444444,1
MTURK,5ba2c2bc7b3bb19711ede5857611abc,3W0KKJIARR9UXX7OBM8N1L3EU8X8KA,0.5,3.0,Lisa Catarineau,86400,916,3423,110,29,806,3394,0.5198090277777778,1
MTURK,5ba2c2bc7b3bb19711ede5857611abc,31MCUE39BKM3UE5Z9ESCCC3A75OG3N,0.5,3.0,Lisa Catarineau,86400,1004,3513,129,39,875,3474,0.5203298611111111,1
MTURK,5ba2c2bc7b3bb19711ede5857611abc,3RZS0FBRWK622YFMOGEEL0RH3YTPC1,0.5,1.0,Goldberg Imports,86400,713,3153,19,5,694,3148,0.5182465277777778,1
